Date,Week,Home Team Name,Away Team Name,Winner,Home Team Total Yards,Away Team Total Yards,Home Team Passing Yards,Away Team Passing Yards,Home Team Passing TD,Away Team Passing TD,Home Team Rushing Yards,Away Team Rushing Yards,Home Team Rushing TD,Away Team Rushing TD,Home Team Turnovers Lost,Away Team Turnovers Lost
2014-09-08,1,ARI,LAC,Home,403,290,294,238,2,1,109,52,0,1,2,2
2014-09-14,2,NYG,ARI,Away,341,266,260,142,2,0,81,124,0,1,0,0
2014-09-21,3,ARI,SFO,Home,338,318,254,236,2,1,84,82,0,1,1,1
2014-10-05,5,DEN,ARI,Home,568,215,476,178,4,1,92,37,1,1,0,0
2014-10-12,6,ARI,WAS,Home,317,407,243,335,2,2,74,72,0,0,0,0
2014-10-19,7,LVR,ARI,Away,220,365,164,242,0,2,56,123,1,1,1,1
2014-10-26,8,ARI,PHI,Home,400,521,329,411,2,2,71,110,1,0,1,1
2014-11-02,9,DAL,ARI,Away,266,339,174,237,1,3,92,102,0,1,1,1
2014-11-09,10,ARI,LAR,Home,335,244,307,174,1,1,28,70,1,1,1,1
2014-11-16,11,ARI,DET,Home,352,262,306,164,2,0,46,98,0,0,2,2
2014-11-23,12,SEA,ARI,Home,293,204,169,140,1,0,124,64,0,0,1,1
2014-11-30,13,ATL,ARI,Home,500,329,358,294,2,1,142,35,0,0,3,3
2014-12-07,14,ARI,KAN,Home,366,390,225,264,1,1,141,126,0,1,0,0
2014-12-11,15,LAR,ARI,Away,280,274,211,131,0,0,69,143,0,0,0,0
2014-12-21,16,ARI,SEA,Away,216,596,187,329,0,2,29,267,0,3,1,1
2014-12-28,17,SFO,ARI,Home,395,397,189,299,2,2,206,98,0,0,3,3
2015-09-13,1,ARI,NOR,Home,427,408,307,354,3,1,120,54,1,0,1,1
2015-09-20,2,CHI,ARI,Away,335,300,226,185,1,4,109,115,1,1,2,2
2015-09-27,3,ARI,SFO,Home,446,156,307,53,2,0,139,103,2,1,1,1
2015-10-04,4,ARI,LAR,Away,447,328,334,164,1,3,113,164,0,0,3,3
2015-10-11,5,DET,ARI,Away,435,345,379,158,2,3,56,187,0,3,0,0
2015-10-18,6,PIT,ARI,Home,310,469,169,414,2,1,141,55,0,0,3,3
2015-10-26,7,ARI,BAL,Home,414,276,264,221,2,1,150,55,1,1,0,0
2015-11-01,8,CLE,ARI,Away,254,491,215,372,3,4,39,119,0,0,4,4
2015-11-15,10,SEA,ARI,Away,343,451,228,334,1,3,115,117,2,1,3,3
2015-11-22,11,ARI,CIN,Home,383,377,301,278,4,2,82,99,0,2,2,2
2015-11-29,12,SFO,ARI,Away,368,337,301,267,1,0,67,70,0,2,0,0
2015-12-06,13,LAR,ARI,Away,212,524,146,349,0,2,66,175,0,1,0,0
2015-12-10,14,ARI,MIN,Home,393,389,296,317,2,1,97,72,0,1,0,0
2015-12-20,15,PHI,ARI,Away,424,493,350,263,2,1,74,230,0,3,0,0
2015-12-27,16,ARI,GNB,Home,381,178,260,77,2,1,121,101,1,0,2,2
2016-01-03,17,ARI,SEA,Away,232,354,205,209,1,3,27,145,0,1,3,3
2016-09-11,1,ARI,NWE,Away,344,363,252,257,2,1,92,106,1,1,0,0
2016-09-18,2,ARI,TAM,Home,416,306,311,221,3,1,105,85,1,0,0,0
2016-09-25,3,BUF,ARI,Home,297,348,89,260,0,0,208,88,3,2,5,5
2016-10-02,4,ARI,LAR,Away,420,288,302,247,1,2,118,41,0,0,5,5
2016-10-06,5,SFO,ARI,Away,286,288,135,116,1,2,151,172,2,2,0,0
2016-10-17,6,ARI,NYJ,Home,396,230,225,197,1,0,171,33,3,0,0,0
2016-10-23,7,ARI,SEA,Away,443,257,311,205,0,0,132,52,0,0,0,0
2016-10-30,8,CAR,ARI,Home,349,340,208,316,0,3,141,24,2,0,2,2
2016-11-13,10,ARI,SFO,Home,443,281,363,198,1,1,80,83,1,1,4,4
2016-11-20,11,MIN,ARI,Home,217,290,145,155,1,2,72,135,1,1,2,2
2016-11-27,12,ATL,ARI,Home,360,332,244,274,2,2,116,58,3,0,1,1
2016-12-04,13,ARI,WAS,Home,369,333,281,246,3,1,88,87,1,1,0,0
2016-12-11,14,MIA,ARI,Home,314,300,231,125,3,2,83,175,0,1,4,4
2016-12-18,15,ARI,NOR,Away,425,488,309,358,2,4,116,130,3,2,2,2
2016-12-24,16,SEA,ARI,Away,391,370,313,276,4,1,78,94,0,3,1,1
2017-01-01,17,LAR,ARI,Away,123,344,71,260,0,3,52,84,0,1,2,2
2017-09-10,1,DET,ARI,Home,367,308,285,263,4,1,82,45,0,1,4,4
2017-09-17,2,IND,ARI,Away,266,389,190,306,0,1,76,83,1,0,1,1
2017-09-25,3,ARI,DAL,Away,332,273,283,174,2,2,49,99,0,2,0,0
2017-10-01,4,ARI,SFO,Home,368,305,317,210,1,0,51,95,0,0,1,1
2017-10-08,5,PHI,ARI,Home,419,307,297,276,4,1,122,31,0,0,1,1
2017-10-15,6,ARI,TAM,Home,432,412,272,344,3,3,160,68,2,1,2,2
2017-10-22,7,LAR,ARI,Home,425,196,228,171,1,0,197,25,2,0,2,2
2017-11-05,9,SFO,ARI,Away,329,368,266,201,0,2,63,167,1,0,2,2
2017-11-09,10,ARI,SEA,Away,290,287,256,212,1,2,34,75,1,0,1,1
2017-11-19,11,HOU,ARI,Home,357,292,223,244,2,3,134,48,2,0,2,2
2017-11-26,12,ARI,JAX,Home,344,219,236,128,2,0,108,91,0,2,2,2
2017-12-03,13,ARI,LAR,Away,305,303,187,213,1,2,118,90,1,0,2,2
2017-12-10,14,ARI,TEN,Home,261,204,125,139,0,0,136,65,0,1,0,0
2017-12-17,15,WAS,ARI,Home,218,286,187,145,2,0,31,141,0,0,2,2
2017-12-24,16,ARI,NYG,Home,289,293,215,250,2,0,74,43,0,0,2,2
2017-12-31,17,SEA,ARI,Away,296,259,195,143,2,1,101,116,0,1,1,1
2018-09-09,1,ARI,WAS,Away,213,429,145,247,0,2,68,182,1,1,2,2
2018-09-16,2,LAR,ARI,Home,432,137,342,83,1,0,90,54,3,0,1,1
2018-09-23,3,ARI,CHI,Away,221,316,168,194,2,0,53,122,0,1,4,4
2018-09-30,4,ARI,SEA,Away,263,331,171,160,1,0,92,171,1,2,1,1
2018-10-07,5,SFO,ARI,Away,447,220,300,164,2,1,147,56,1,2,0,0
2018-10-14,6,MIN,ARI,Home,411,268,216,208,1,0,195,60,2,1,2,2
2018-10-18,7,ARI,DEN,Away,223,309,154,178,1,2,69,131,0,2,5,5
2018-10-28,8,ARI,SFO,Home,321,267,233,160,2,1,88,107,0,0,2,2
2018-11-11,10,KAN,ARI,Home,330,260,212,166,2,1,118,94,1,1,2,2
2018-11-18,11,ARI,LVR,Away,282,325,128,173,3,2,154,152,0,0,2,2
2018-11-25,12,LAC,ARI,Home,414,149,236,87,3,1,178,62,3,0,1,1
2018-12-02,13,GNB,ARI,Away,325,315,227,133,1,0,98,182,1,2,0,0
2018-12-09,14,ARI,DET,Away,279,218,218,96,0,0,61,122,0,1,1,1
2018-12-16,15,ATL,ARI,Home,435,253,220,193,2,1,215,60,2,1,3,3
2018-12-23,16,ARI,LAR,Away,263,461,159,192,1,1,104,269,0,3,0,0
2018-12-30,17,SEA,ARI,Home,291,198,109,113,1,1,182,85,2,0,2,2
2019-09-08,1,ARI,DET,Away,387,477,275,361,2,3,112,116,0,0,1,1
2019-09-15,2,BAL,ARI,Home,440,349,258,329,2,0,182,20,0,1,0,0
2019-09-22,3,ARI,CAR,Away,248,413,127,240,2,4,121,173,0,1,2,2
2019-09-29,4,ARI,SEA,Away,321,340,206,225,0,1,115,115,1,1,1,1
2019-10-06,5,CIN,ARI,Away,370,514,262,248,2,0,108,266,0,2,0,0
2019-10-13,6,ARI,ATL,Home,442,444,340,341,3,4,102,103,1,0,0,0
2019-10-20,7,NYG,ARI,Away,263,245,156,89,1,0,107,156,1,3,0,0
2019-10-27,8,NOR,ARI,Home,510,237,373,197,3,0,137,40,1,0,0,0
2019-10-31,9,ARI,SFO,Away,357,411,204,310,2,4,153,101,1,0,0,0
2019-11-10,10,TAM,ARI,Home,457,417,339,342,1,3,118,75,2,0,2,2
2019-11-17,11,SFO,ARI,Home,442,266,408,131,4,2,34,135,0,1,2,2
2019-12-01,13,ARI,LAR,Away,198,549,124,417,0,2,74,132,1,1,1,1
2019-12-08,14,ARI,PIT,Away,236,275,165,135,2,1,71,140,0,0,3,3
2019-12-15,15,ARI,CLE,Home,445,393,219,241,1,2,226,152,4,1,1,1
2019-12-22,16,SEA,ARI,Away,224,412,133,159,1,1,91,253,0,2,0,0
2019-12-29,17,LAR,ARI,Home,424,393,311,322,3,2,113,71,1,1,5,5
2020-09-13,1,SFO,ARI,Away,366,404,243,224,2,1,123,180,0,2,1,1
2020-09-20,2,ARI,WAS,Home,438,316,278,199,1,1,160,117,2,1,1,1
2020-09-27,3,ARI,DET,Away,377,322,268,232,2,2,109,90,1,0,3,3
2020-10-04,4,CAR,ARI,Home,444,262,276,133,2,3,168,129,2,0,1,1
2020-10-11,5,NYJ,ARI,Away,285,496,162,369,1,1,123,127,0,3,1,1
2020-10-19,6,DAL,ARI,Away,344,438,247,177,1,2,97,261,0,3,0,0
2020-10-25,7,ARI,SEA,Home,519,572,360,372,3,3,159,200,1,1,2,2
2020-11-08,9,ARI,MIA,Away,442,312,264,221,3,2,178,91,1,1,1,1
2020-11-15,10,ARI,BUF,Home,453,369,236,296,1,3,217,73,2,0,2,2
2020-11-19,11,SEA,ARI,Home,347,314,182,257,2,2,165,57,1,1,0,0
2020-11-29,12,NWE,ARI,Home,179,298,69,160,0,0,110,138,2,2,1,1
2020-12-06,13,ARI,LAR,Away,232,463,140,344,3,1,92,119,1,3,2,2
2020-12-13,14,NYG,ARI,Away,159,390,81,231,0,1,78,159,1,1,0,0
2020-12-20,15,ARI,PHI,Home,526,422,423,305,3,3,103,117,1,1,3,3
2020-12-26,16,ARI,SFO,Away,350,398,230,171,0,3,120,227,1,0,2,2
2021-01-03,17,LAR,ARI,Home,333,214,223,166,0,1,110,48,0,0,1,1
2021-09-12,1,TEN,ARI,Away,248,416,162,280,1,4,86,136,1,1,1,1
2021-09-19,2,ARI,MIN,Home,474,419,371,242,3,3,103,177,1,0,2,2
2021-09-26,3,JAX,ARI,Away,361,407,202,316,1,0,159,91,1,3,1,1
2021-10-03,4,LAR,ARI,Away,401,465,280,249,2,2,121,216,0,2,0,0
2021-10-10,5,ARI,SFO,Home,304,338,210,186,1,0,94,152,1,1,1,1
2021-10-17,6,CLE,ARI,Away,290,352,217,208,2,4,73,144,0,0,0,0
2021-10-24,7,ARI,HOU,Home,397,160,225,118,3,0,172,42,1,0,1,1
2021-10-28,8,ARI,GNB,Away,334,335,260,184,0,2,74,151,3,1,3,3
2021-11-07,9,SFO,ARI,Away,337,437,298,274,2,1,39,163,0,3,0,0
2021-11-14,10,ARI,CAR,Away,169,341,104,175,0,1,65,166,1,2,2,2
2021-11-21,11,SEA,ARI,Away,266,413,180,318,0,2,86,95,1,1,0,0
2021-12-05,13,CHI,ARI,Away,329,257,217,120,2,2,112,137,1,2,0,0
2021-12-13,14,ARI,LAR,Away,447,356,344,267,0,3,103,89,2,0,2,2
2021-12-19,15,DET,ARI,Home,338,398,212,293,3,1,126,105,0,0,1,1
2021-12-25,16,ARI,IND,Away,378,346,245,220,1,2,133,126,1,0,0,0
2022-01-02,17,DAL,ARI,Away,301,399,256,272,3,2,45,127,0,0,0,0
2022-01-09,18,ARI,SEA,Away,305,431,187,229,1,3,118,202,1,2,1,1
2022-09-11,1,ARI,KAN,Away,282,488,179,360,2,5,103,128,1,1,0,0
2022-09-18,2,LVR,ARI,Away,324,413,244,270,2,1,80,143,0,2,1,1
2022-09-25,3,ARI,LAR,Away,365,339,295,239,0,0,70,100,0,2,0,0
2022-10-02,4,CAR,ARI,Away,220,338,180,206,1,2,40,132,0,1,1,1
2022-10-09,5,ARI,PHI,Away,363,357,239,218,1,0,124,139,1,2,1,1
2022-10-16,6,SEA,ARI,Home,296,315,160,171,0,0,136,144,1,0,2,2
2022-10-20,7,ARI,NOR,Home,326,494,189,409,1,4,137,85,2,0,0,0
2022-10-30,8,MIN,ARI,Home,381,375,208,297,2,3,173,78,3,0,3,3
2022-11-06,9,ARI,SEA,Away,262,421,140,263,2,2,122,158,0,2,1,1
2022-11-13,10,LAR,ARI,Away,256,298,190,220,1,1,66,78,1,2,0,0
2022-11-21,11,ARI,SFO,Away,314,387,247,228,0,4,67,159,1,1,2,2
2022-11-27,12,ARI,LAC,Away,366,311,185,246,2,3,181,65,1,0,2,2
2022-12-12,14,ARI,NWE,Away,323,328,210,225,0,0,113,103,1,2,2,2
2022-12-18,15,DEN,ARI,Home,324,240,156,167,1,0,168,73,2,1,3,3
2022-12-25,16,ARI,TAM,Away,325,396,204,281,0,1,121,115,1,0,3,3
2023-01-01,17,ATL,ARI,Home,298,339,166,213,0,1,132,126,2,0,0,0
2023-01-08,18,SFO,ARI,Home,311,255,142,194,3,1,169,61,2,1,4,4
2023-09-10,1,WAS,ARI,Home,248,210,156,114,1,0,92,96,1,0,2,2
2023-09-17,2,ARI,NYG,Away,379,439,228,312,1,2,151,127,2,2,0,0
2023-09-24,3,ARI,DAL,Home,400,416,178,231,1,1,222,185,2,0,0,0
2023-10-01,4,SFO,ARI,Home,395,362,271,257,1,2,124,105,4,0,0,0
2023-10-08,5,ARI,CIN,Away,294,380,152,287,2,3,142,93,1,0,3,3
2023-10-15,6,LAR,ARI,Home,382,345,203,215,1,0,179,130,1,0,2,2
2023-10-22,7,SEA,ARI,Home,318,249,203,122,2,0,115,127,0,1,0,0
2023-10-29,8,ARI,BAL,Away,310,268,181,138,2,1,129,130,1,3,2,2
2023-11-05,9,CLE,ARI,Home,326,58,213,17,2,0,113,41,1,0,3,3
2023-11-12,10,ARI,ATL,Home,352,254,230,70,0,1,122,184,2,2,1,1
2023-11-19,11,HOU,ARI,Home,419,319,308,196,2,1,111,123,1,1,2,2
2023-11-26,12,ARI,LAR,Away,292,457,219,229,1,4,73,228,1,1,0,0
2023-12-03,13,PIT,ARI,Away,317,282,187,132,1,1,130,150,0,2,0,0
2023-12-17,15,ARI,SFO,Away,436,406,202,262,1,4,234,144,2,1,2,2
2023-12-24,16,CHI,ARI,Home,420,306,170,213,1,2,250,93,2,0,0,0
2023-12-31,17,PHI,ARI,Away,275,449,184,228,3,3,91,221,0,1,1,1
2024-01-07,18,ARI,SEA,Away,466,327,260,189,1,2,206,138,1,0,0,0
2014-09-07,1,ATL,NOR,Home,568,472,445,333,3,1,123,139,1,3,1,1
2014-09-14,2,CIN,ATL,Home,472,309,302,212,1,1,170,97,2,0,3,3
2014-09-18,3,ATL,TAM,Home,488,217,344,153,3,1,144,64,3,0,4,4
2014-09-28,4,MIN,ATL,Home,558,411,317,288,0,3,241,123,4,1,2,2
2014-10-05,5,NYG,ATL,Home,317,397,193,307,2,1,124,90,1,1,1,1
2014-10-12,6,ATL,CHI,Away,287,478,245,375,1,1,42,103,0,2,1,1
2014-10-19,7,BAL,ATL,Home,371,254,248,186,2,1,123,68,1,0,1,1
2014-10-26,8,ATL,DET,Away,291,385,213,325,2,2,78,60,1,0,1,1
2014-11-09,10,TAM,ATL,Away,373,322,281,212,2,1,92,110,0,1,0,0
2014-11-16,11,CAR,ATL,Away,391,346,285,260,2,1,106,86,0,0,1,1
2014-11-23,12,ATL,CLE,Away,315,475,252,313,2,0,63,162,1,2,2,2
2014-11-30,13,ATL,ARI,Home,500,329,358,294,2,1,142,35,0,0,1,1
2014-12-08,14,GNB,ATL,Home,502,465,323,374,3,4,179,91,2,1,1,1
2014-12-14,15,ATL,PIT,Away,407,398,310,353,2,0,97,45,0,2,1,1
2014-12-21,16,NOR,ATL,Away,328,403,271,322,1,1,57,81,1,1,0,0
2014-12-28,17,ATL,CAR,Away,288,306,225,112,0,1,63,194,0,1,3,3
2015-09-14,1,ATL,PHI,Home,395,399,290,336,2,1,105,63,0,2,2,2
2015-09-20,2,NYG,ATL,Away,388,402,291,346,2,1,97,56,0,2,0,0
2015-09-27,3,DAL,ATL,Away,347,438,220,280,0,2,127,158,4,3,0,0
2015-10-04,4,ATL,HOU,Home,378,428,243,374,1,2,135,54,4,1,0,0
2015-10-11,5,ATL,WAS,Home,418,270,242,219,0,1,176,51,1,1,3,3
2015-10-15,6,NOR,ATL,Home,385,413,304,263,1,2,81,150,2,1,3,3
2015-10-25,7,TEN,ATL,Away,256,378,179,251,1,1,77,127,0,0,2,2
2015-11-01,8,ATL,TAM,Away,496,290,395,173,2,1,101,117,0,1,4,4
2015-11-08,9,SFO,ATL,Home,318,302,185,285,2,1,133,17,0,0,0,0
2015-11-22,11,ATL,IND,Away,375,276,275,202,3,2,100,74,0,0,4,4
2015-11-29,12,ATL,MIN,Away,326,365,210,174,1,0,116,191,0,2,3,3
2015-12-06,13,TAM,ATL,Home,388,319,222,255,1,1,166,64,2,0,1,1
2015-12-13,14,CAR,ATL,Home,424,230,282,176,3,0,142,54,2,0,4,4
2015-12-20,15,JAX,ATL,Away,370,328,285,245,1,1,85,83,1,1,1,1
2015-12-27,16,ATL,CAR,Home,373,268,296,113,1,0,77,155,1,1,1,1
2016-01-03,17,ATL,NOR,Away,414,390,327,323,2,1,87,67,0,1,2,2
2016-09-11,1,ATL,TAM,Away,374,371,322,281,2,4,52,90,0,0,0,0
2016-09-18,2,LVR,ATL,Away,454,528,299,389,3,3,155,139,1,1,1,1
2016-09-26,3,NOR,ATL,Away,474,442,359,225,3,2,115,217,1,3,0,0
2016-10-02,4,ATL,CAR,Home,571,378,481,329,4,3,90,49,1,0,1,1
2016-10-09,5,DEN,ATL,Away,267,372,183,250,1,1,84,122,0,1,1,1
2016-10-16,6,SEA,ATL,Home,333,362,261,310,0,3,72,52,3,0,2,2
2016-10-23,7,ATL,LAC,Away,386,426,256,348,1,1,130,78,1,2,1,1
2016-10-30,8,ATL,GNB,Home,367,331,277,223,3,4,90,108,1,0,0,0
2016-11-03,9,TAM,ATL,Away,396,461,326,325,4,4,70,136,0,1,1,1
2016-11-13,10,PHI,ATL,Home,429,303,221,255,0,1,208,48,2,0,1,1
2016-11-27,12,ATL,ARI,Home,360,332,244,274,2,2,116,58,3,0,1,1
2016-12-04,13,ATL,KAN,Away,418,389,290,266,1,1,128,123,2,2,1,1
2016-12-11,14,LAR,ATL,Away,312,286,208,220,0,3,104,66,2,1,0,0
2016-12-18,15,ATL,SFO,Home,550,272,302,165,2,2,248,107,3,0,1,1
2016-12-24,16,CAR,ATL,Away,302,408,183,256,1,2,119,152,0,1,0,0
2017-01-01,17,ATL,NOR,Home,465,473,323,341,4,2,142,132,1,2,0,0
2017-09-10,1,CHI,ATL,Away,301,372,176,308,1,1,125,64,1,1,0,0
2017-09-17,2,ATL,GNB,Home,364,367,223,308,1,2,141,59,2,1,0,0
2017-09-24,3,DET,ATL,Away,324,428,253,277,1,2,71,151,0,1,3,3
2017-10-01,4,ATL,BUF,Away,389,281,242,164,1,1,147,117,1,0,3,3
2017-10-15,6,ATL,MIA,Away,339,289,239,151,1,2,100,138,1,0,1,1
2017-10-22,7,NWE,ATL,Home,403,343,241,223,2,1,162,120,0,0,0,0
2017-10-29,8,NYJ,ATL,Away,279,386,236,246,2,2,43,140,0,0,2,2
2017-11-05,9,CAR,ATL,Home,330,355,129,302,0,2,201,53,2,0,1,1
2017-11-12,10,ATL,DAL,Home,336,233,204,126,2,0,132,107,1,1,1,1
2017-11-20,11,SEA,ATL,Away,360,279,224,190,2,2,136,89,1,1,1,1
2017-11-26,12,ATL,TAM,Home,516,373,368,279,2,0,148,94,2,2,1,1
2017-12-03,13,ATL,MIN,Away,275,312,173,207,0,2,102,105,0,0,0,0
2017-12-07,14,ATL,NOR,Home,343,306,211,256,1,2,132,50,1,0,3,3
2017-12-18,15,TAM,ATL,Away,373,410,289,209,3,1,84,201,0,1,0,0
2017-12-24,16,NOR,ATL,Home,315,331,229,264,1,1,86,67,1,0,2,2
2017-12-31,17,ATL,CAR,Home,371,248,311,161,1,1,60,87,0,0,0,0
2018-09-06,1,PHI,ATL,Home,232,299,119,225,0,0,113,74,2,1,1,1
2018-09-16,2,ATL,CAR,Home,442,439,272,318,2,3,170,121,2,0,1,1
2018-09-23,3,ATL,NOR,Away,407,534,359,391,5,3,48,143,0,2,0,0
2018-09-30,4,ATL,CIN,Away,495,407,403,308,3,3,92,99,1,2,0,0
2018-10-07,5,PIT,ATL,Home,381,324,250,262,3,1,131,62,2,1,1,1
2018-10-14,6,ATL,TAM,Home,417,510,347,389,3,4,70,121,1,0,0,0
2018-10-22,7,ATL,NYG,Home,423,433,356,372,1,1,67,61,1,1,1,1
2018-11-04,9,WAS,ATL,Away,366,491,287,337,1,4,79,154,1,1,1,1
2018-11-11,10,CLE,ATL,Home,427,382,216,311,3,2,211,71,1,0,2,2
2018-11-18,11,ATL,DAL,Away,354,323,274,191,1,0,80,132,0,2,1,1
2018-11-22,12,NOR,ATL,Home,312,366,162,340,4,2,150,26,0,0,4,4
2018-12-02,13,ATL,BAL,Away,131,366,97,159,1,0,34,207,0,1,1,1
2018-12-09,14,GNB,ATL,Home,300,344,162,237,2,3,138,107,1,0,2,2
2018-12-16,15,ATL,ARI,Home,435,253,220,193,2,1,215,60,2,1,0,0
2018-12-23,16,CAR,ATL,Away,436,427,295,233,1,3,141,194,0,0,2,2
2018-12-30,17,TAM,ATL,Away,433,489,341,380,4,3,92,109,0,1,1,1
2019-09-08,1,MIN,ATL,Home,269,345,97,272,1,2,172,73,3,0,3,3
2019-09-15,2,ATL,PHI,Home,367,286,310,237,3,1,57,49,0,1,3,3
2019-09-22,3,IND,ATL,Home,379,397,300,304,2,3,79,93,1,0,1,1
2019-09-29,4,ATL,TEN,Away,422,365,364,227,0,3,58,138,1,0,1,1
2019-10-06,5,HOU,ATL,Home,592,373,426,316,5,3,166,57,1,1,1,1
2019-10-13,6,ARI,ATL,Home,442,444,340,341,3,4,102,103,1,0,0,0
2019-10-20,7,ATL,LAR,Away,224,381,186,291,1,2,38,90,0,1,3,3
2019-10-27,8,ATL,SEA,Away,510,322,441,171,1,2,69,151,1,1,3,3
2019-11-10,10,NOR,ATL,Away,310,317,258,174,0,2,52,143,0,0,1,1
2019-11-17,11,CAR,ATL,Away,347,349,270,295,0,1,77,54,0,1,0,0
2019-11-24,12,ATL,TAM,Away,337,446,280,313,1,3,57,133,1,1,2,2
2019-11-28,13,ATL,NOR,Away,348,279,259,184,2,1,89,95,0,1,3,3
2019-12-08,14,ATL,CAR,Home,461,345,302,245,2,1,159,100,2,1,0,0
2019-12-15,15,SFO,ATL,Away,313,290,193,201,1,2,120,89,1,1,1,1
2019-12-22,16,ATL,JAX,Home,518,288,383,173,1,1,135,115,2,0,2,2
2019-12-29,17,TAM,ATL,Away,329,373,193,286,2,1,136,87,0,0,1,1
2020-09-13,1,ATL,SEA,Away,506,383,434,299,2,4,72,84,1,1,2,2
2020-09-20,2,DAL,ATL,Home,570,380,445,267,1,4,125,113,4,0,0,0
2020-09-27,3,ATL,CHI,Away,371,437,227,307,1,4,144,130,2,0,1,1
2020-10-05,4,GNB,ATL,Home,403,327,315,249,4,0,88,78,0,2,0,0
2020-10-11,5,ATL,CAR,Away,373,437,207,313,0,2,166,124,1,0,1,1
2020-10-18,6,MIN,ATL,Away,365,462,333,363,3,4,32,99,0,0,1,1
2020-10-25,7,ATL,DET,Away,388,386,322,322,1,1,66,64,2,1,1,1
2020-10-29,8,CAR,ATL,Away,304,401,157,270,1,0,147,131,1,2,1,1
2020-11-08,9,ATL,DEN,Home,363,405,271,302,3,2,92,103,1,1,1,1
2020-11-22,11,NOR,ATL,Home,376,248,210,196,0,0,166,52,3,0,2,2
2020-11-29,12,ATL,LVR,Home,304,243,179,203,2,0,125,40,1,0,1,1
2020-12-06,13,ATL,NOR,Away,332,424,262,217,1,2,70,207,0,1,1,1
2020-12-13,14,LAC,ATL,Home,345,319,240,249,2,2,105,70,0,0,3,3
2020-12-20,15,ATL,TAM,Away,369,416,332,365,3,2,37,51,0,2,0,0
2020-12-27,16,KAN,ATL,Home,395,367,278,277,2,2,117,90,0,0,1,1
2021-01-03,17,TAM,ATL,Home,485,385,391,258,4,2,94,127,1,1,2,2
2021-09-12,1,ATL,PHI,Away,260,434,136,261,0,3,124,173,0,1,0,0
2021-09-19,2,TAM,ATL,Home,341,348,259,293,5,2,82,55,0,1,3,3
2021-09-26,3,NYG,ATL,Away,346,296,246,227,0,2,100,69,1,0,1,1
2021-10-03,4,ATL,WAS,Away,374,412,275,290,4,3,99,122,0,1,0,0
2021-10-10,5,ATL,NYJ,Home,450,230,342,166,2,0,108,64,1,2,2,2
2021-10-24,7,MIA,ATL,Away,413,397,281,325,4,2,132,72,0,1,2,2
2021-10-31,8,ATL,CAR,Away,213,332,131,129,1,0,82,203,0,1,2,2
2021-11-07,9,NOR,ATL,Away,376,366,267,332,2,2,109,34,1,1,0,0
2021-11-14,10,DAL,ATL,Home,431,214,317,111,2,0,114,103,3,0,3,3
2021-11-18,11,ATL,NWE,Away,165,308,125,174,0,1,40,134,0,0,4,4
2021-11-28,12,JAX,ATL,Away,357,332,216,183,1,1,141,149,0,2,1,1
2021-12-05,13,ATL,TAM,Away,380,425,259,368,0,4,121,57,1,0,1,1
2021-12-12,14,CAR,ATL,Away,334,318,243,190,1,1,91,128,2,1,1,1
2021-12-19,15,SFO,ATL,Home,397,275,235,213,1,1,162,62,3,0,1,1
2021-12-26,16,ATL,DET,Home,254,338,207,208,1,1,47,130,1,0,1,1
2022-01-02,17,BUF,ATL,Home,351,265,118,169,0,0,233,96,4,1,1,1
2022-01-09,18,ATL,NOR,Away,257,369,195,174,1,3,62,195,1,0,3,3
2022-09-11,1,ATL,NOR,Away,416,385,215,234,0,2,201,151,2,1,2,2
2022-09-18,2,LAR,ATL,Home,337,261,272,171,3,2,65,90,1,0,3,3
2022-09-25,3,SEA,ATL,Away,420,386,308,207,2,1,112,179,0,2,2,2
2022-10-02,4,ATL,CLE,Home,333,403,131,226,0,0,202,177,2,2,1,1
2022-10-09,5,TAM,ATL,Home,420,261,351,110,1,1,69,151,1,1,0,0
2022-10-16,6,ATL,SFO,Home,289,346,121,296,2,2,168,50,1,0,0,0
2022-10-23,7,CIN,ATL,Home,537,214,459,107,3,1,78,107,2,1,0,0
2022-10-30,8,ATL,CAR,Home,406,478,239,309,3,1,167,169,0,3,2,2
2022-11-06,9,ATL,LAC,Away,315,336,114,245,0,1,201,91,2,1,2,2
2022-11-10,10,CAR,ATL,Home,333,291,101,153,0,2,232,138,2,0,1,1
2022-11-20,11,ATL,CHI,Home,280,288,131,128,1,1,149,160,1,2,2,2
2022-11-27,12,WAS,ATL,Home,314,332,138,165,2,1,176,167,0,0,1,1
2022-12-04,13,ATL,PIT,Away,306,351,160,197,1,1,146,154,0,0,1,1
2022-12-18,15,NOR,ATL,Home,348,320,214,89,3,0,134,231,0,2,1,1
2022-12-24,16,BAL,ATL,Home,299,327,115,212,1,0,184,115,0,0,1,1
2023-01-01,17,ATL,ARI,Home,298,339,166,213,0,1,132,126,2,0,1,1
2023-01-08,18,ATL,TAM,Home,382,222,208,136,2,2,174,86,1,0,1,1
2023-09-10,1,ATL,CAR,Home,221,281,91,127,1,1,130,154,2,0,0,0
2023-09-17,2,ATL,GNB,Home,446,224,235,140,1,3,211,84,1,0,1,1
2023-09-24,3,DET,ATL,Home,358,183,243,139,1,0,115,44,1,0,1,1
2023-10-01,4,JAX,ATL,Home,300,287,195,160,1,1,105,127,0,0,3,3
2023-10-08,5,ATL,HOU,Home,447,313,351,249,1,1,96,64,1,0,2,2
2023-10-15,6,ATL,WAS,Away,402,193,296,121,2,3,106,72,0,0,3,3
2023-10-22,7,TAM,ATL,Away,329,401,256,245,1,0,73,156,0,1,3,3
2023-10-29,8,TEN,ATL,Home,375,342,226,202,4,1,149,140,0,1,1,1
2023-11-05,9,ATL,MIN,Away,370,363,260,217,1,2,110,146,1,1,2,2
2023-11-12,10,ARI,ATL,Home,352,254,230,70,0,1,122,184,2,2,0,0
2023-11-26,12,ATL,NOR,Home,396,444,168,296,1,0,228,148,1,0,2,2
2023-12-03,13,NYJ,ATL,Away,259,194,197,104,0,1,62,90,0,0,0,0
2023-12-10,14,ATL,TAM,Away,434,290,338,142,1,2,96,148,2,1,1,1
2023-12-17,15,CAR,ATL,Home,283,204,154,152,0,1,129,52,0,0,2,2
2023-12-24,16,ATL,IND,Home,406,262,229,170,1,0,177,92,1,1,0,0
2023-12-31,17,CHI,ATL,Home,432,307,240,173,1,1,192,134,3,1,4,4
2024-01-07,18,NOR,ATL,Home,400,389,246,311,4,2,154,78,2,0,3,3
2014-09-07,1,BAL,CIN,Away,423,380,329,301,1,1,94,79,1,0,2,2
2014-09-11,2,BAL,PIT,Home,323,301,166,202,2,0,157,99,0,0,0,0
2014-09-21,3,CLE,BAL,Away,375,377,290,217,1,1,85,160,2,1,1,1
2014-09-28,4,BAL,CAR,Home,454,315,327,248,3,1,127,67,2,0,0,0
2014-10-05,5,IND,BAL,Home,432,287,305,197,1,0,127,90,1,1,3,3
2014-10-12,6,TAM,BAL,Away,364,475,277,306,2,5,87,169,0,1,1,1
2014-10-19,7,BAL,ATL,Home,371,254,248,186,2,1,123,68,1,0,3,3
2014-10-26,8,CIN,BAL,Home,350,294,239,187,0,0,111,107,3,2,2,2
2014-11-02,9,PIT,BAL,Home,376,332,321,269,6,2,55,63,0,0,2,2
2014-11-09,10,BAL,TEN,Home,312,210,161,143,1,1,151,67,2,0,0,0
2014-11-24,12,NOR,BAL,Away,525,449,399,234,3,1,126,215,0,2,1,1
2014-11-30,13,BAL,LAC,Away,350,440,225,376,2,3,125,64,1,1,0,0
2014-12-07,14,MIA,BAL,Away,249,447,186,264,1,2,63,183,0,2,1,1
2014-12-14,15,BAL,JAX,Home,314,248,221,166,1,0,93,82,0,0,1,1
2014-12-21,16,HOU,BAL,Home,313,211,190,178,1,2,123,33,0,0,3,3
2014-12-28,17,BAL,CLE,Home,419,259,290,150,2,0,129,109,0,1,0,0
2015-09-13,1,DEN,BAL,Home,219,173,150,100,0,0,69,73,0,0,2,2
2015-09-20,2,LVR,BAL,Home,448,493,351,384,3,2,97,109,1,1,2,2
2015-09-27,3,BAL,CIN,Away,398,458,362,372,2,3,36,86,0,1,1,1
2015-10-01,4,PIT,BAL,Away,263,356,96,165,1,1,167,191,1,1,2,2
2015-10-11,5,BAL,CLE,Away,377,505,196,422,1,2,181,83,3,1,0,0
2015-10-18,6,SFO,BAL,Home,391,420,326,343,2,2,65,77,0,0,2,2
2015-10-26,7,ARI,BAL,Home,414,276,264,221,2,1,150,55,1,1,2,2
2015-11-01,8,BAL,LAC,Home,365,371,293,290,1,3,72,81,1,0,0,0
2015-11-15,10,BAL,JAX,Away,397,258,308,168,3,2,89,90,0,0,4,4
2015-11-22,11,BAL,LAR,Home,388,213,292,131,1,1,96,82,0,1,2,2
2015-11-30,12,CLE,BAL,Away,338,336,275,232,2,2,63,104,0,0,2,2
2015-12-06,13,MIA,BAL,Home,219,375,82,281,1,1,137,94,0,0,2,2
2015-12-13,14,BAL,SEA,Away,302,424,274,301,0,5,28,123,0,0,2,2
2015-12-20,15,BAL,KAN,Away,366,277,273,164,2,1,93,113,0,1,3,3
2015-12-27,16,BAL,PIT,Home,386,308,265,198,1,0,121,110,1,2,0,0
2016-01-03,17,CIN,BAL,Home,292,341,147,282,2,1,145,59,1,0,2,2
2016-09-11,1,BAL,BUF,Home,308,160,225,95,1,0,83,65,0,1,1,1
2016-09-18,2,CLE,BAL,Away,387,382,242,302,2,2,145,80,1,0,2,2
2016-09-25,3,JAX,BAL,Away,216,283,168,199,2,0,48,84,0,1,3,3
2016-10-02,4,BAL,LVR,Away,412,261,282,199,1,4,130,62,2,0,1,1
2016-10-09,5,BAL,WAS,Away,306,310,188,250,1,1,118,60,0,0,1,1
2016-10-16,6,NYG,BAL,Home,435,391,397,293,3,0,38,98,0,2,0,0
2016-10-23,7,NYJ,BAL,Home,344,245,189,234,2,0,155,11,1,0,3,3
2016-11-06,9,BAL,PIT,Home,274,277,224,241,1,1,50,36,0,1,1,1
2016-11-10,10,BAL,CLE,Home,396,144,277,111,3,1,119,33,0,0,2,2
2016-11-20,11,DAL,BAL,Home,417,368,299,267,3,1,118,101,0,1,0,0
2016-11-27,12,BAL,CIN,Home,311,325,219,261,1,1,92,64,0,0,1,1
2016-12-04,13,BAL,MIA,Home,496,277,386,215,4,1,110,62,1,0,2,2
2016-12-12,14,NWE,BAL,Home,496,348,401,306,3,2,95,42,1,0,1,1
2016-12-18,15,BAL,PHI,Home,340,328,189,159,2,0,151,169,1,2,2,2
2016-12-25,16,PIT,BAL,Home,406,368,279,246,3,1,127,122,1,1,1,1
2017-01-01,17,CIN,BAL,Home,371,335,218,263,1,0,153,72,2,1,2,2
2017-09-10,1,CIN,BAL,Away,221,268,144,111,0,1,77,157,0,1,1,1
2017-09-17,2,BAL,CLE,Home,337,386,201,293,2,1,136,93,1,0,2,2
2017-09-24,3,JAX,BAL,Home,410,186,244,52,4,1,166,134,1,0,3,3
2017-10-01,4,BAL,PIT,Away,288,381,206,208,1,1,82,173,0,2,3,3
2017-10-08,5,LVR,BAL,Away,245,365,137,222,1,0,108,143,1,2,0,0
2017-10-15,6,BAL,CHI,Away,291,342,166,111,0,2,125,231,0,0,3,3
2017-10-22,7,MIN,BAL,Home,357,208,188,144,0,1,169,64,1,0,0,0
2017-10-26,8,BAL,MIA,Home,295,196,121,151,2,0,174,45,0,0,0,0
2017-11-05,9,TEN,BAL,Home,257,341,186,268,2,2,71,73,1,0,2,2
2017-11-19,11,GNB,BAL,Away,265,219,190,161,0,1,75,58,0,1,1,1
2017-11-27,12,BAL,HOU,Home,294,303,155,237,0,0,139,66,2,1,0,0
2017-12-03,13,BAL,DET,Home,370,372,269,294,2,1,101,78,2,2,0,0
2017-12-10,14,PIT,BAL,Home,545,413,486,261,2,2,59,152,2,3,1,1
2017-12-17,15,CLE,BAL,Away,266,376,136,279,0,1,130,97,1,1,0,0
2017-12-23,16,BAL,IND,Home,323,296,220,203,2,1,103,93,0,0,0,0
2017-12-31,17,BAL,CIN,Away,312,359,194,213,2,3,118,146,1,0,1,1
2018-09-09,1,BAL,BUF,Home,369,153,252,70,3,0,117,83,3,0,1,1
2018-09-13,2,CIN,BAL,Home,373,425,265,359,4,2,108,66,0,1,3,3
2018-09-23,3,BAL,DEN,Home,342,293,265,173,1,0,77,120,2,2,0,0
2018-09-30,4,PIT,BAL,Away,284,451,265,355,1,2,19,96,0,0,1,1
2018-10-07,5,CLE,BAL,Home,416,410,304,294,1,0,112,116,0,0,2,2
2018-10-14,6,TEN,BAL,Away,106,361,51,238,0,1,55,123,0,2,1,1
2018-10-21,7,BAL,NOR,Away,351,339,274,205,2,2,77,134,1,1,0,0
2018-10-28,8,CAR,BAL,Home,386,325,232,224,2,2,154,101,2,1,3,3
2018-11-04,9,BAL,PIT,Away,265,395,204,282,0,2,61,113,1,1,0,0
2018-11-18,11,BAL,CIN,Home,403,255,136,207,0,2,267,48,2,1,1,1
2018-11-25,12,BAL,LVR,Home,416,249,174,182,1,1,242,67,1,1,2,2
2018-12-02,13,ATL,BAL,Away,131,366,97,159,1,0,34,207,0,1,1,1
2018-12-09,14,KAN,BAL,Home,442,321,348,127,2,2,94,194,1,1,1,1
2018-12-16,15,BAL,TAM,Home,370,241,128,156,1,0,242,85,1,1,2,2
2018-12-22,16,LAC,BAL,Away,198,361,147,202,0,1,51,159,1,0,1,1
2018-12-30,17,BAL,CLE,Home,463,426,167,376,0,3,296,50,2,0,1,1
2019-09-08,1,MIA,BAL,Away,200,643,179,378,1,6,21,265,0,2,0,0
2019-09-15,2,BAL,ARI,Home,440,349,258,329,2,0,182,20,0,1,0,0
2019-09-22,3,KAN,BAL,Home,503,452,363,249,3,0,140,203,1,4,0,0
2019-09-29,4,BAL,CLE,Away,395,530,222,337,3,1,173,193,0,4,3,3
2019-10-06,5,PIT,BAL,Away,269,277,192,139,1,1,77,138,1,1,3,3
2019-10-13,6,BAL,CIN,Home,497,250,228,217,0,0,269,33,2,1,1,1
2019-10-20,7,SEA,BAL,Away,347,340,241,141,1,0,106,199,0,1,0,0
2019-11-03,9,BAL,NWE,Home,372,342,162,268,1,1,210,74,3,1,2,2
2019-11-10,10,CIN,BAL,Away,307,379,150,243,1,3,157,136,0,2,1,1
2019-11-17,11,BAL,HOU,Home,491,232,235,110,4,0,256,122,1,1,0,0
2019-11-25,12,LAR,BAL,Away,221,480,199,195,0,5,22,285,0,1,0,0
2019-12-01,13,BAL,SFO,Home,283,331,105,157,1,1,178,174,1,1,1,1
2019-12-08,14,BUF,BAL,Away,209,257,105,139,1,3,104,118,0,0,1,1
2019-12-12,15,BAL,NYJ,Home,430,310,212,207,5,2,218,103,1,0,0,0
2019-12-22,16,CLE,BAL,Away,241,481,184,238,2,3,57,243,0,1,1,1
2019-12-29,17,BAL,PIT,Home,304,168,81,77,0,0,223,91,1,1,2,2
2020-09-13,1,BAL,CLE,Home,381,306,270,168,3,1,111,138,2,0,1,1
2020-09-20,2,HOU,BAL,Away,304,407,253,177,1,1,51,230,0,1,0,0
2020-09-28,3,BAL,KAN,Away,228,517,70,385,1,4,158,132,0,1,1,1
2020-10-04,4,WAS,BAL,Away,343,350,274,206,0,2,69,144,2,2,2,2
2020-10-11,5,BAL,CIN,Home,332,205,171,135,2,0,161,70,0,0,1,1
2020-10-18,6,PHI,BAL,Away,364,355,170,173,2,1,194,182,1,2,0,0
2020-11-01,8,BAL,PIT,Away,457,221,192,173,2,2,265,48,1,1,4,4
2020-11-08,9,IND,BAL,Away,339,266,227,156,0,0,112,110,1,2,1,1
2020-11-15,10,NWE,BAL,Home,308,357,135,242,2,2,173,115,1,0,1,1
2020-11-22,11,BAL,TEN,Away,306,423,177,250,1,2,129,173,1,1,1,1
2020-12-02,12,PIT,BAL,Home,334,219,266,90,1,1,68,129,0,1,2,2
2020-12-08,13,BAL,DAL,Home,401,388,107,277,2,2,294,111,2,0,1,1
2020-12-14,14,CLE,BAL,Away,493,385,355,154,2,1,138,231,4,5,0,0
2020-12-20,15,BAL,JAX,Home,409,267,250,205,3,2,159,62,2,0,1,1
2020-12-27,16,BAL,NYG,Home,432,269,183,215,2,1,249,54,1,0,1,1
2021-01-03,17,CIN,BAL,Away,195,525,48,121,0,3,147,404,0,2,1,1
2021-09-13,1,LVR,BAL,Home,491,406,409,217,2,1,82,189,2,2,2,2
2021-09-19,2,BAL,KAN,Home,481,405,230,343,1,3,251,62,3,1,2,2
2021-09-26,3,DET,BAL,Away,285,387,192,271,0,1,93,116,2,0,1,1
2021-10-03,4,DEN,BAL,Away,254,406,148,304,1,1,106,102,0,1,0,0
2021-10-11,5,BAL,IND,Home,523,513,437,390,4,2,86,123,0,1,1,1
2021-10-17,6,BAL,LAC,Home,327,208,140,182,1,1,187,26,3,0,2,2
2021-10-24,7,BAL,CIN,Away,393,520,278,409,1,3,115,111,1,2,0,0
2021-11-07,9,BAL,MIN,Home,500,318,253,187,3,2,247,131,1,1,2,2
2021-11-11,10,MIA,BAL,Home,350,304,290,210,0,1,60,94,1,0,2,2
2021-11-21,11,CHI,BAL,Away,353,299,261,176,2,0,92,123,0,1,1,1
2021-11-28,12,BAL,CLE,Home,303,262,155,222,1,1,148,40,0,0,4,4
2021-12-05,13,PIT,BAL,Home,321,326,236,219,2,1,85,107,0,1,1,1
2021-12-12,14,CLE,BAL,Home,290,389,190,271,2,1,100,118,0,1,2,2
2021-12-19,15,BAL,GNB,Away,354,346,211,250,2,3,143,96,2,1,0,0
2021-12-26,16,CIN,BAL,Home,575,334,498,295,4,2,77,39,1,1,1,1
2022-01-02,17,BAL,LAR,Away,327,373,162,300,0,2,165,73,0,1,2,2
2022-01-09,18,BAL,PIT,Away,381,314,132,235,0,1,249,79,1,0,3,3
2022-09-11,1,NYJ,BAL,Away,380,274,297,211,1,3,83,63,0,0,1,1
2022-09-18,2,BAL,MIA,Away,473,547,318,461,3,6,155,86,1,0,0,0
2022-09-25,3,NWE,BAL,Away,447,394,302,206,0,4,145,188,3,1,2,2
2022-10-02,4,BAL,BUF,Away,296,326,134,201,1,1,162,125,1,1,2,2
2022-10-09,5,BAL,CIN,Home,325,291,170,190,1,1,155,101,0,1,1,1
2022-10-16,6,NYG,BAL,Home,238,406,155,195,2,1,83,211,1,1,2,2
2022-10-23,7,BAL,CLE,Home,254,336,94,223,0,0,160,113,2,2,1,1
2022-10-27,8,TAM,BAL,Away,349,453,305,222,1,2,44,231,1,1,0,0
2022-11-07,9,NOR,BAL,Away,243,319,195,131,1,1,48,188,0,2,0,0
2022-11-20,11,BAL,CAR,Home,308,205,193,169,0,0,115,36,1,0,1,1
2022-11-27,12,JAX,BAL,Home,332,415,294,253,3,1,38,162,0,1,2,2
2022-12-04,13,BAL,DEN,Home,285,272,182,184,0,0,103,88,1,0,2,2
2022-12-11,14,PIT,BAL,Away,329,309,264,94,1,0,65,215,1,1,0,0
2022-12-17,15,CLE,BAL,Home,283,324,140,126,1,0,143,198,0,0,2,2
2022-12-24,16,BAL,ATL,Home,299,327,115,212,1,0,184,115,0,0,0,0
2023-01-01,17,BAL,PIT,Away,240,351,120,153,1,1,120,198,0,0,1,1
2023-01-08,18,CIN,BAL,Home,257,386,202,276,1,0,55,110,1,1,4,4
2023-09-10,1,BAL,HOU,Home,265,268,155,196,0,0,110,72,3,0,2,2
2023-09-17,2,CIN,BAL,Away,282,415,216,237,2,2,66,178,0,1,0,0
2023-09-24,3,BAL,IND,Away,364,327,178,188,0,1,186,139,2,0,2,2
2023-10-01,4,CLE,BAL,Away,166,296,73,165,0,2,93,131,0,2,1,1
2023-10-08,5,PIT,BAL,Home,289,335,202,210,1,0,87,125,0,1,3,3
2023-10-15,6,TEN,BAL,Away,233,360,104,221,0,1,129,139,1,0,1,1
2023-10-22,7,BAL,DET,Home,503,337,357,253,3,0,146,84,2,1,1,1
2023-10-29,8,ARI,BAL,Away,310,268,181,138,2,1,129,130,1,3,0,0
2023-11-05,9,BAL,SEA,Home,515,151,217,123,1,0,298,28,3,0,2,2
2023-11-12,10,BAL,CLE,Away,306,373,200,195,1,1,106,178,2,1,2,2
2023-11-16,11,BAL,CIN,Home,405,272,248,136,2,2,157,136,2,0,0,0
2023-11-26,12,LAC,BAL,Away,279,361,193,164,1,1,86,197,0,1,0,0
2023-12-10,14,BAL,LAR,Home,449,410,310,282,3,3,139,128,0,0,1,1
2023-12-17,15,JAX,BAL,Away,333,396,258,145,1,1,75,251,0,1,1,1
2023-12-25,16,SFO,BAL,Away,429,343,308,241,1,2,121,102,1,1,0,0
2023-12-31,17,BAL,MIA,Home,491,375,331,221,6,2,160,154,2,0,1,1
2024-01-06,18,BAL,PIT,Away,224,289,118,134,1,1,106,155,0,1,2,2
2014-09-07,1,CHI,BUF,Away,427,360,341,167,2,1,86,193,0,1,1,1
2014-09-14,2,BUF,MIA,Home,315,290,202,210,1,1,113,80,0,0,0,0
2014-09-21,3,BUF,LAC,Away,292,333,205,250,1,2,87,83,0,0,0,0
2014-09-28,4,HOU,BUF,Home,301,316,264,220,1,2,37,96,0,0,2,2
2014-10-05,5,DET,BUF,Away,273,343,204,294,1,1,69,49,0,0,1,1
2014-10-12,6,BUF,NWE,Away,336,396,268,346,2,4,68,50,1,0,3,3
2014-10-19,7,BUF,MIN,Home,373,276,255,118,2,1,118,158,0,0,4,4
2014-10-26,8,NYJ,BUF,Away,312,280,137,213,0,4,175,67,3,1,0,0
2014-11-09,10,BUF,KAN,Away,364,278,253,151,1,0,111,127,0,2,3,3
2014-11-13,11,MIA,BUF,Home,330,237,205,183,2,0,125,54,0,0,0,0
2014-11-24,12,BUF,NYJ,Home,336,218,220,126,2,0,116,92,2,0,0,0
2014-11-30,13,BUF,CLE,Home,287,315,181,241,1,0,106,74,0,1,2,2
2014-12-07,14,DEN,BUF,Home,306,415,173,341,0,1,133,74,3,1,3,3
2014-12-14,15,BUF,GNB,Home,253,333,140,175,0,0,113,158,0,1,1,1
2014-12-21,16,LVR,BUF,Home,347,321,207,308,2,3,140,13,0,0,2,2
2014-12-28,17,NWE,BUF,Away,260,268,144,164,0,1,116,104,0,1,1,1
2015-09-13,1,BUF,IND,Home,342,304,195,240,1,2,147,64,2,0,0,0
2015-09-20,2,BUF,NWE,Away,349,507,189,451,3,3,160,56,2,1,3,3
2015-09-27,3,MIA,BUF,Away,391,428,289,277,2,3,102,151,0,1,0,0
2015-10-04,4,BUF,NYG,Away,313,303,258,211,1,3,55,92,0,0,2,2
2015-10-11,5,TEN,BUF,Away,276,209,179,82,0,1,97,127,1,1,1,1
2015-10-18,6,BUF,CIN,Away,368,355,256,243,1,3,112,112,2,1,1,1
2015-10-25,7,JAX,BUF,Home,295,375,175,260,2,2,120,115,1,0,4,4
2015-11-08,9,BUF,MIA,Home,420,397,154,289,1,0,266,108,3,2,0,0
2015-11-12,10,NYJ,BUF,Away,318,280,190,132,2,1,128,148,0,0,0,0
2015-11-23,11,NWE,BUF,Home,356,319,271,225,1,0,85,94,1,1,1,1
2015-11-29,12,KAN,BUF,Home,413,415,255,286,2,3,158,129,1,0,2,2
2015-12-06,13,BUF,HOU,Home,390,401,203,275,3,3,187,126,1,0,0,0
2015-12-13,14,PHI,BUF,Home,348,412,232,260,1,1,116,152,1,1,2,2
2015-12-20,15,WAS,BUF,Home,431,452,308,212,4,2,123,240,1,1,0,0
2015-12-27,16,BUF,DAL,Home,408,307,172,186,0,0,236,121,2,0,2,2
2016-01-03,17,BUF,NYJ,Home,295,300,182,178,0,2,113,122,2,0,1,1
2016-09-11,1,BAL,BUF,Home,308,160,225,95,1,0,83,65,0,1,0,0
2016-09-15,2,BUF,NYJ,Away,393,493,307,370,3,1,86,123,0,3,1,1
2016-09-25,3,BUF,ARI,Home,297,348,89,260,0,0,208,88,3,2,1,1
2016-10-02,4,NWE,BUF,Away,277,378,187,244,0,1,90,134,0,0,0,0
2016-10-09,5,LAR,BUF,Away,345,305,243,112,0,2,102,193,1,1,0,0
2016-10-16,6,BUF,SFO,Home,492,300,179,167,2,1,313,133,4,0,2,2
2016-10-23,7,MIA,BUF,Home,454,267,198,200,1,1,256,67,2,2,0,0
2016-10-30,8,BUF,NWE,Away,376,357,209,285,0,4,167,72,3,1,0,0
2016-11-07,9,SEA,BUF,Home,278,425,245,263,2,1,33,162,2,2,1,1
2016-11-20,11,CIN,BUF,Away,300,342,207,159,1,0,93,183,1,1,1,1
2016-11-27,12,BUF,JAX,Home,304,301,151,118,1,2,153,183,3,1,0,0
2016-12-04,13,LVR,BUF,Home,399,382,260,170,2,0,139,212,2,3,2,2
2016-12-11,14,BUF,PIT,Away,275,460,208,220,2,0,67,240,1,3,1,1
2016-12-18,15,BUF,CLE,Home,451,269,171,162,1,0,280,107,3,1,0,0
2016-12-24,16,BUF,MIA,Away,589,494,317,233,3,2,272,261,1,2,0,0
2017-01-01,17,NYJ,BUF,Home,329,230,202,162,2,0,127,68,0,1,3,3
2017-09-10,1,BUF,NYJ,Home,408,214,218,176,2,0,190,38,1,1,1,1
2017-09-17,2,CAR,BUF,Home,255,176,178,107,0,0,77,69,0,0,0,0
2017-09-24,3,BUF,DEN,Home,272,366,197,255,2,0,75,111,0,1,0,0
2017-10-01,4,ATL,BUF,Away,389,281,242,164,1,1,147,117,1,0,0,0
2017-10-08,5,CIN,BUF,Home,388,221,323,139,1,1,65,82,1,0,1,1
2017-10-22,7,BUF,TAM,Home,434,447,261,378,1,3,173,69,2,0,1,1
2017-10-29,8,BUF,LVR,Home,331,367,165,313,1,1,166,54,2,1,0,0
2017-11-02,9,NYJ,BUF,Home,331,307,137,244,1,2,194,63,3,1,3,3
2017-11-12,10,BUF,NOR,Away,198,482,129,184,1,0,69,298,0,6,1,1
2017-11-19,11,LAC,BUF,Home,429,393,283,220,2,1,146,173,2,2,6,6
2017-11-26,12,KAN,BUF,Away,236,268,181,164,1,1,55,104,0,0,0,0
2017-12-03,13,BUF,NWE,Away,268,435,85,244,0,0,183,191,0,2,1,1
2017-12-10,14,BUF,IND,Home,319,227,92,64,1,1,227,163,1,0,2,2
2017-12-17,15,BUF,MIA,Home,328,349,212,249,1,0,116,100,2,1,0,0
2017-12-24,16,NWE,BUF,Home,411,326,218,242,2,0,193,84,2,0,0,0
2017-12-31,17,MIA,BUF,Away,356,312,263,186,1,1,93,126,1,1,0,0
2018-09-09,1,BAL,BUF,Home,369,153,252,70,3,0,117,83,3,0,2,2
2018-09-16,2,BUF,LAC,Away,293,349,209,240,1,3,84,109,1,1,2,2
2018-09-23,3,MIN,BUF,Away,292,292,278,164,1,1,14,128,0,2,0,0
2018-09-30,4,GNB,BUF,Home,423,145,282,87,1,0,141,58,1,0,3,3
2018-10-07,5,BUF,TEN,Home,223,221,79,121,0,0,144,100,1,0,1,1
2018-10-14,6,HOU,BUF,Home,216,229,142,129,1,1,74,100,0,0,3,3
2018-10-21,7,IND,BUF,Home,376,303,156,168,4,0,220,135,1,0,5,5
2018-10-29,8,BUF,NWE,Away,333,387,287,311,0,0,46,76,0,1,2,2
2018-11-04,9,BUF,CHI,Away,264,190,166,126,0,1,98,64,1,2,4,4
2018-11-11,10,NYJ,BUF,Away,199,451,116,239,0,2,83,212,1,2,0,0
2018-11-25,12,BUF,JAX,Home,327,333,160,107,1,1,167,226,2,2,0,0
2018-12-02,13,MIA,BUF,Home,175,415,115,217,3,2,60,198,0,0,3,3
2018-12-09,14,BUF,NYJ,Away,368,248,192,170,0,1,176,78,2,2,3,3
2018-12-16,15,BUF,DET,Home,312,313,195,208,1,1,117,105,1,1,0,0
2018-12-23,16,NWE,BUF,Home,390,289,117,217,1,1,273,72,2,0,3,3
2018-12-30,17,BUF,MIA,Home,381,225,215,126,3,1,166,99,3,0,1,1
2019-09-08,1,NYJ,BUF,Away,223,370,155,242,1,1,68,128,0,1,4,4
2019-09-15,2,NYG,BUF,Away,370,388,241,237,1,1,129,151,1,3,0,0
2019-09-22,3,BUF,CIN,Home,416,306,241,240,1,1,175,66,1,1,2,2
2019-09-29,4,BUF,NWE,Away,375,224,240,150,0,0,135,74,1,1,4,4
2019-10-06,5,TEN,BUF,Away,252,313,150,204,0,2,102,109,1,0,1,1
2019-10-20,7,BUF,MIA,Home,305,381,188,272,2,1,117,109,0,2,0,0
2019-10-27,8,BUF,PHI,Away,253,371,155,153,2,1,98,218,0,3,1,1
2019-11-03,9,BUF,WAS,Home,268,243,146,116,1,0,122,127,2,0,0,0
2019-11-10,10,CLE,BUF,Home,368,344,221,260,2,0,147,84,0,2,0,0
2019-11-17,11,MIA,BUF,Away,303,424,280,256,0,3,23,168,2,1,0,0
2019-11-24,12,BUF,DEN,Home,424,134,180,49,2,0,244,85,0,0,1,1
2019-11-28,13,DAL,BUF,Away,426,356,323,232,2,2,103,124,0,1,0,0
2019-12-08,14,BUF,BAL,Away,209,257,105,139,1,3,104,118,0,0,1,1
2019-12-15,15,PIT,BUF,Away,229,261,178,131,1,1,51,130,0,1,2,2
2019-12-21,16,NWE,BUF,Home,414,268,271,176,1,2,143,92,1,0,0,0
2019-12-29,17,BUF,NYJ,Away,309,271,236,185,0,1,73,86,0,0,3,3
2020-09-13,1,BUF,NYJ,Home,404,254,306,202,2,1,98,52,1,1,2,2
2020-09-20,2,MIA,BUF,Away,410,523,311,411,2,4,99,112,1,0,1,1
2020-09-27,3,BUF,LAR,Home,375,478,274,311,4,2,101,167,1,2,2,2
2020-10-04,4,LVR,BUF,Away,383,337,297,274,2,2,86,63,0,2,0,0
2020-10-13,5,TEN,BUF,Home,334,370,195,275,3,2,139,95,3,0,3,3
2020-10-19,6,BUF,KAN,Away,206,466,122,221,2,2,84,245,0,1,1,1
2020-10-25,7,NYJ,BUF,Away,191,422,91,296,0,0,100,126,1,0,1,1
2020-11-01,8,BUF,NWE,Home,339,349,149,161,0,0,190,188,3,2,1,1
2020-11-08,9,BUF,SEA,Home,420,419,386,362,3,2,34,57,2,2,0,0
2020-11-15,10,ARI,BUF,Home,453,369,236,296,1,3,217,73,2,0,2,2
2020-11-29,12,BUF,LAC,Home,332,367,160,291,2,1,172,76,1,1,3,3
2020-12-07,13,SFO,BUF,Away,402,449,316,368,3,4,86,81,0,0,1,1
2020-12-13,14,BUF,PIT,Home,334,224,230,177,2,2,104,47,0,0,2,2
2020-12-19,15,DEN,BUF,Away,255,534,115,352,1,2,140,182,2,3,1,1
2020-12-28,16,NWE,BUF,Away,201,474,56,344,0,4,145,130,1,1,0,0
2021-01-03,17,BUF,MIA,Home,455,454,377,384,4,1,78,70,2,2,2,2
2021-09-12,1,BUF,PIT,Away,371,252,254,177,1,1,117,75,0,0,1,1
2021-09-19,2,MIA,BUF,Away,216,314,145,171,0,2,71,143,0,3,2,2
2021-09-26,3,BUF,WAS,Home,481,290,359,212,4,2,122,78,1,1,0,0
2021-10-03,4,BUF,HOU,Home,450,109,251,61,2,0,199,48,2,0,1,1
2021-10-10,5,KAN,BUF,Away,392,436,272,315,2,3,120,121,0,1,0,0
2021-10-18,6,TEN,BUF,Home,362,417,216,335,0,3,146,82,4,0,1,1
2021-10-31,8,BUF,MIA,Home,351,262,249,194,2,0,102,68,1,1,0,0
2021-11-07,9,JAX,BUF,Home,218,301,139,229,0,0,79,72,0,0,3,3
2021-11-14,10,NYJ,BUF,Away,366,489,296,350,1,2,70,139,1,4,2,2
2021-11-21,11,BUF,IND,Away,311,370,220,106,2,1,91,264,0,4,4,4
2021-11-25,12,NOR,BUF,Away,190,361,146,248,1,4,44,113,0,0,2,2
2021-12-06,13,BUF,NWE,Away,230,241,131,19,1,0,99,222,0,1,1,1
2021-12-12,14,TAM,BUF,Home,488,466,351,293,2,2,137,173,2,1,1,1
2021-12-19,15,BUF,CAR,Home,312,275,193,124,3,1,119,151,1,1,1,1
2021-12-26,16,NWE,BUF,Away,288,428,139,314,0,3,149,114,3,1,0,0
2022-01-02,17,BUF,ATL,Home,351,265,118,169,0,0,233,96,4,1,3,3
2022-01-09,18,BUF,NYJ,Home,424,53,254,5,2,1,170,48,1,0,0,0
2022-09-08,1,LAR,BUF,Away,243,413,191,292,1,3,52,121,0,1,4,4
2022-09-19,2,BUF,TEN,Home,414,187,313,107,4,0,101,80,0,1,0,0
2022-09-25,3,MIA,BUF,Home,212,497,171,382,1,2,41,115,2,0,1,1
2022-10-02,4,BAL,BUF,Away,296,326,134,201,1,1,162,125,1,1,2,2
2022-10-09,5,BUF,PIT,Home,552,364,432,310,4,0,120,54,1,0,2,2
2022-10-16,6,KAN,BUF,Away,387,443,319,318,2,3,68,125,0,0,1,1
2022-10-30,8,BUF,GNB,Home,369,398,216,190,2,2,153,208,1,0,2,2
2022-11-06,9,NYJ,BUF,Home,310,317,136,183,1,0,174,134,1,2,2,2
2022-11-13,10,BUF,MIN,Away,486,481,311,334,1,1,175,147,2,2,4,4
2022-11-20,11,BUF,CLE,Home,357,396,186,316,1,3,171,80,1,0,0,0
2022-11-24,12,DET,BUF,Away,326,401,230,237,2,2,96,164,1,1,1,1
2022-12-01,13,NWE,BUF,Away,242,355,182,223,1,2,60,132,0,1,1,1
2022-12-11,14,BUF,NYJ,Home,232,309,130,233,1,0,102,76,1,1,0,0
2022-12-17,15,BUF,MIA,Home,446,405,296,217,4,2,150,188,0,1,1,1
2022-12-24,16,CHI,BUF,Away,209,426,129,172,1,2,80,254,0,3,3,3
2023-01-08,18,BUF,NWE,Home,327,341,237,234,3,3,90,107,0,0,3,3
2023-09-11,1,NYJ,BUF,Home,289,314,117,217,1,1,172,97,0,0,4,4
2023-09-17,2,BUF,LVR,Home,450,240,267,185,3,1,183,55,2,0,0,0
2023-09-24,3,WAS,BUF,Away,230,386,125,218,0,1,105,168,0,2,1,1
2023-10-01,4,BUF,MIA,Home,414,393,310,251,4,1,104,142,2,2,0,0
2023-10-08,5,BUF,JAX,Away,388,474,359,278,2,1,29,196,1,2,2,2
2023-10-15,6,BUF,NYG,Home,297,317,169,185,2,0,128,132,0,0,2,2
2023-10-22,7,NWE,BUF,Home,364,339,268,258,2,2,96,81,1,1,2,2
2023-10-26,8,BUF,TAM,Home,427,302,312,224,2,2,115,78,1,0,1,1
2023-11-05,9,CIN,BUF,Home,397,317,343,249,2,1,54,68,1,1,2,2
2023-11-13,10,BUF,DEN,Away,369,300,177,178,1,2,192,122,2,0,4,4
2023-11-19,11,BUF,NYJ,Home,393,155,263,92,3,1,130,63,0,0,1,1
2023-11-26,12,PHI,BUF,Home,378,505,193,332,3,2,185,173,2,2,1,1
2023-12-10,14,KAN,BUF,Away,346,327,264,209,1,1,82,118,1,1,1,1
2023-12-17,15,BUF,DAL,Home,351,195,85,106,1,0,266,89,3,1,0,0
2023-12-23,16,LAC,BUF,Away,273,335,175,230,0,1,98,105,1,2,3,3
2023-12-31,17,BUF,NWE,Home,281,294,154,191,0,0,127,103,2,2,1,1
2024-01-07,18,MIA,BUF,Away,275,473,167,345,1,2,108,128,1,0,3,3
2014-09-07,1,TAM,CAR,Away,264,334,162,221,2,2,102,113,0,0,0,0
2014-09-14,2,CAR,DET,Home,313,323,251,253,1,1,62,70,1,0,0,0
2014-09-21,3,CAR,PIT,Away,349,454,307,190,2,2,42,264,0,1,2,2
2014-09-28,4,BAL,CAR,Home,454,315,327,248,3,1,127,67,2,0,1,1
2014-10-05,5,CAR,CHI,Home,322,347,231,262,2,2,91,85,1,1,3,3
2014-10-12,6,CIN,CAR,Home,513,431,320,284,2,2,193,147,2,2,1,1
2014-10-19,7,GNB,CAR,Home,363,331,241,223,3,2,122,108,2,0,1,1
2014-10-26,8,CAR,SEA,Away,266,310,152,191,0,1,114,119,0,0,2,2
2014-10-30,9,CAR,NOR,Away,231,375,122,270,0,1,109,105,1,3,2,2
2014-11-10,10,PHI,CAR,Home,365,317,328,215,2,2,37,102,2,1,5,5
2014-11-16,11,CAR,ATL,Away,391,346,285,260,2,1,106,86,0,0,2,2
2014-11-30,13,MIN,CAR,Home,210,348,118,170,2,1,92,178,0,0,1,1
2014-12-07,14,NOR,CAR,Away,310,497,218,226,1,3,92,271,0,2,0,0
2014-12-14,15,CAR,TAM,Home,392,287,269,136,1,1,123,151,0,1,1,1
2014-12-21,16,CAR,CLE,Home,404,228,195,144,1,1,209,84,1,0,2,2
2014-12-28,17,ATL,CAR,Away,288,306,225,112,0,1,63,194,0,1,0,0
2015-09-13,1,JAX,CAR,Away,265,263,169,158,1,1,96,105,0,0,1,1
2015-09-20,2,CAR,HOU,Home,350,300,178,239,2,1,172,61,1,1,1,1
2015-09-27,3,CAR,NOR,Home,431,380,312,310,2,0,119,70,1,2,0,0
2015-10-04,4,TAM,CAR,Away,411,244,270,111,2,2,141,133,1,0,1,1
2015-10-18,6,SEA,CAR,Away,334,383,219,248,1,1,115,135,1,3,2,2
2015-10-25,7,CAR,PHI,Home,394,349,190,172,1,0,204,177,2,1,3,3
2015-11-02,8,CAR,IND,Home,379,359,239,223,2,2,140,136,1,0,3,3
2015-11-08,9,CAR,GNB,Home,427,402,297,331,3,4,130,71,1,0,1,1
2015-11-15,10,TEN,CAR,Away,242,303,178,184,0,1,64,119,1,2,0,0
2015-11-22,11,CAR,WAS,Home,368,186,226,172,5,1,142,14,0,0,0,0
2015-11-26,12,DAL,CAR,Away,210,294,179,165,1,0,31,129,0,1,0,0
2015-12-06,13,NOR,CAR,Away,334,497,264,322,3,5,70,175,1,1,3,3
2015-12-13,14,CAR,ATL,Home,424,230,282,176,3,0,142,54,2,0,0,0
2015-12-20,15,NYG,CAR,Away,406,480,245,309,4,5,161,171,1,0,1,1
2015-12-27,16,ATL,CAR,Home,373,268,296,113,1,0,77,155,1,1,1,1
2016-01-03,17,CAR,TAM,Home,366,386,255,309,2,0,111,77,3,1,2,2
2016-09-08,1,DEN,CAR,Home,307,333,159,176,1,1,148,157,2,1,1,1
2016-09-18,2,CAR,SFO,Home,529,302,353,237,4,2,176,65,0,1,4,4
2016-09-25,3,CAR,MIN,Away,306,211,201,153,0,1,105,58,1,0,3,3
2016-10-02,4,ATL,CAR,Home,571,378,481,329,4,3,90,49,1,0,2,2
2016-10-10,5,CAR,TAM,Away,414,315,278,202,0,1,136,113,2,0,4,4
2016-10-16,6,NOR,CAR,Home,523,406,460,303,4,2,63,103,1,3,2,2
2016-10-30,8,CAR,ARI,Home,349,340,208,316,0,3,141,24,2,0,1,1
2016-11-06,9,LAR,CAR,Away,339,244,280,185,1,1,59,59,0,0,0,0
2016-11-13,10,CAR,KAN,Away,341,256,242,165,1,0,99,91,1,0,2,2
2016-11-17,11,CAR,NOR,Home,223,371,173,264,1,2,50,107,1,0,0,0
2016-11-27,12,LVR,CAR,Home,366,358,310,229,2,2,56,129,1,3,2,2
2016-12-04,13,SEA,CAR,Home,534,271,294,182,1,1,240,89,3,0,2,2
2016-12-11,14,CAR,LAC,Home,272,278,146,220,1,2,126,58,1,0,1,1
2016-12-19,15,WAS,CAR,Away,335,438,306,290,0,2,29,148,1,0,0,0
2016-12-24,16,CAR,ATL,Away,302,408,183,256,1,2,119,152,0,1,2,2
2017-01-01,17,TAM,CAR,Home,300,335,188,207,1,1,112,128,0,1,3,3
2017-09-10,1,SFO,CAR,Away,217,287,166,171,0,2,51,116,0,0,2,2
2017-09-17,2,CAR,BUF,Home,255,176,178,107,0,0,77,69,0,0,0,0
2017-09-24,3,CAR,NOR,Away,288,362,156,213,0,3,132,149,1,1,3,3
2017-10-01,4,NWE,CAR,Away,373,444,293,304,2,3,80,140,1,1,2,2
2017-10-08,5,DET,CAR,Away,242,362,192,334,2,3,50,28,1,0,0,0
2017-10-12,6,CAR,PHI,Away,305,310,225,209,1,3,80,101,1,0,3,3
2017-10-22,7,CHI,CAR,Home,153,293,85,185,0,0,68,108,0,0,3,3
2017-10-29,8,TAM,CAR,Away,279,254,194,154,0,1,85,100,0,1,1,1
2017-11-05,9,CAR,ATL,Home,330,355,129,302,0,2,201,53,2,0,2,2
2017-11-13,10,CAR,MIA,Home,548,313,254,213,4,2,294,100,2,1,0,0
2017-11-26,12,NYJ,CAR,Away,391,299,282,154,3,0,109,145,0,2,0,0
2017-12-03,13,NOR,CAR,Home,400,279,252,167,1,2,148,112,3,1,1,1
2017-12-10,14,CAR,MIN,Home,345,356,129,256,1,2,216,100,3,0,1,1
2017-12-17,15,CAR,GNB,Home,387,384,236,264,4,3,151,120,0,0,0,0
2017-12-24,16,CAR,TAM,Home,255,392,140,326,0,1,115,66,1,0,1,1
2017-12-31,17,ATL,CAR,Home,371,248,311,161,1,1,60,87,0,0,3,3
2018-09-09,1,CAR,DAL,Home,293,232,146,138,0,0,147,94,2,1,1,1
2018-09-16,2,ATL,CAR,Home,442,439,272,318,2,3,170,121,2,0,1,1
2018-09-23,3,CAR,CIN,Home,377,396,147,330,2,2,230,66,2,1,0,0
2018-10-07,5,CAR,NYG,Home,350,432,232,382,2,3,118,50,0,0,2,2
2018-10-14,6,WAS,CAR,Home,288,350,156,269,2,2,132,81,0,0,3,3
2018-10-21,7,PHI,CAR,Away,342,371,284,250,2,2,58,121,0,1,0,0
2018-10-28,8,CAR,BAL,Home,386,325,232,224,2,2,154,101,2,1,0,0
2018-11-04,9,CAR,TAM,Home,407,301,228,219,2,4,179,82,4,0,0,0
2018-11-08,10,PIT,CAR,Home,457,242,319,147,5,2,138,95,1,1,2,2
2018-11-18,11,DET,CAR,Home,309,387,215,331,1,3,94,56,1,0,1,1
2018-11-25,12,CAR,SEA,Away,476,397,256,322,2,2,220,75,1,1,1,1
2018-12-02,13,TAM,CAR,Home,315,444,220,276,2,2,95,168,1,0,4,4
2018-12-09,14,CLE,CAR,Home,348,393,232,297,1,0,116,96,2,2,1,1
2018-12-17,15,CAR,NOR,Away,247,346,149,191,1,0,98,155,0,1,2,2
2018-12-23,16,CAR,ATL,Away,436,427,295,233,1,3,141,194,0,0,4,4
2018-12-30,17,NOR,CAR,Away,294,374,110,263,1,2,184,111,1,2,0,0
2019-09-08,1,CAR,LAR,Away,343,349,216,183,0,1,127,166,3,2,3,3
2019-09-12,2,CAR,TAM,Away,352,289,313,189,0,1,39,100,0,1,1,1
2019-09-22,3,ARI,CAR,Away,248,413,127,240,2,4,121,173,0,1,1,1
2019-09-29,4,HOU,CAR,Away,264,297,128,203,0,0,136,94,1,1,3,3
2019-10-06,5,CAR,JAX,Home,445,507,160,358,1,2,285,149,3,1,0,0
2019-10-13,6,TAM,CAR,Away,407,268,365,209,1,2,42,59,2,2,1,1
2019-10-27,8,SFO,CAR,Home,388,230,156,100,2,0,232,130,5,1,3,3
2019-11-03,9,CAR,TEN,Home,370,431,214,310,2,1,156,121,2,2,1,1
2019-11-10,10,GNB,CAR,Home,388,401,225,281,0,1,163,120,3,1,2,2
2019-11-17,11,CAR,ATL,Away,347,349,270,295,0,1,77,54,0,1,4,4
2019-11-24,12,NOR,CAR,Home,418,351,300,230,3,3,118,121,1,1,1,1
2019-12-01,13,CAR,WAS,Away,278,362,213,114,2,0,65,248,1,3,2,2
2019-12-08,14,ATL,CAR,Home,461,345,302,245,2,1,159,100,2,1,4,4
2019-12-15,15,CAR,SEA,Away,414,428,269,274,1,2,145,154,2,2,3,3
2019-12-22,16,IND,CAR,Home,324,286,106,199,0,0,218,87,3,0,3,3
2019-12-29,17,CAR,NOR,Away,329,379,288,264,0,3,41,115,1,2,3,3
2020-09-13,1,CAR,LVR,Away,388,372,259,239,1,1,129,133,2,3,0,0
2020-09-20,2,TAM,CAR,Home,339,427,217,340,1,0,122,87,3,2,4,4
2020-09-27,3,LAC,CAR,Away,436,302,319,221,1,1,117,81,1,0,0,0
2020-10-04,4,CAR,ARI,Home,444,262,276,133,2,3,168,129,2,0,1,1
2020-10-11,5,ATL,CAR,Away,373,437,207,313,0,2,166,124,1,0,0,0
2020-10-18,6,CAR,CHI,Away,303,261,191,198,0,1,112,63,1,1,3,3
2020-10-25,7,NOR,CAR,Home,415,283,277,246,2,2,138,37,1,1,0,0
2020-10-29,8,CAR,ATL,Away,304,401,157,270,1,0,147,131,1,2,1,1
2020-11-08,9,KAN,CAR,Home,397,435,361,331,4,2,36,104,0,2,0,0
2020-11-15,10,CAR,TAM,Away,187,544,122,334,2,3,65,210,1,2,1,1
2020-11-22,11,CAR,DET,Home,374,185,258,145,1,0,116,40,1,0,2,2
2020-11-29,12,MIN,CAR,Home,387,374,291,267,3,1,96,107,0,0,1,1
2020-12-13,14,CAR,DEN,Away,370,365,245,269,0,4,125,96,3,0,0,0
2020-12-19,15,GNB,CAR,Home,291,364,96,249,1,0,195,115,2,1,1,1
2020-12-27,16,WAS,CAR,Away,386,280,278,167,1,1,108,113,0,1,2,2
2021-01-03,17,CAR,NOR,Away,320,347,246,191,0,3,74,156,1,1,5,5
2021-09-12,1,CAR,NYJ,Home,381,252,270,207,1,2,111,45,1,0,1,1
2021-09-19,2,CAR,NOR,Home,383,128,294,80,2,0,89,48,1,1,1,1
2021-09-23,3,HOU,CAR,Away,193,407,151,290,1,0,42,117,0,3,0,0
2021-10-03,4,DAL,CAR,Home,433,379,188,266,4,2,245,113,1,2,2,2
2021-10-10,5,CAR,PHI,Away,267,273,158,182,1,0,109,91,0,2,3,3
2021-10-17,6,CAR,MIN,Away,306,571,188,373,1,3,118,198,1,1,3,3
2021-10-24,7,NYG,CAR,Home,302,173,199,117,1,0,103,56,1,0,1,1
2021-10-31,8,ATL,CAR,Away,213,332,131,129,1,0,82,203,0,1,1,1
2021-11-07,9,CAR,NWE,Away,240,273,162,122,0,1,78,151,0,1,3,3
2021-11-14,10,ARI,CAR,Away,169,341,104,175,0,1,65,166,1,2,2,2
2021-11-21,11,CAR,WAS,Away,297,369,186,179,2,3,111,190,1,0,0,0
2021-11-28,12,MIA,CAR,Home,315,198,204,134,1,0,111,64,2,1,3,3
2021-12-12,14,CAR,ATL,Away,334,318,243,190,1,1,91,128,2,1,3,3
2021-12-19,15,BUF,CAR,Home,312,275,193,124,3,1,119,151,1,1,1,1
2021-12-26,16,CAR,TAM,Away,273,391,206,232,0,1,67,159,0,2,1,1
2022-01-02,17,NOR,CAR,Home,280,178,207,90,1,0,73,88,0,1,2,2
2022-01-09,18,TAM,CAR,Home,409,317,324,207,3,2,85,110,2,0,2,2
2022-09-11,1,CAR,CLE,Away,261,355,207,138,1,1,54,217,2,1,1,1
2022-09-18,2,NYG,CAR,Home,265,275,162,129,1,1,103,146,0,0,2,2
2022-09-25,3,CAR,NOR,Home,293,426,148,342,1,1,145,84,0,1,0,0
2022-10-02,4,CAR,ARI,Away,220,338,180,206,1,2,40,132,0,1,3,3
2022-10-09,5,CAR,SFO,Away,308,397,244,244,0,2,64,153,1,2,1,1
2022-10-16,6,LAR,CAR,Home,360,203,249,110,1,0,111,93,2,0,1,1
2022-10-23,7,CAR,TAM,Home,343,322,170,276,2,0,173,46,1,0,0,0
2022-10-30,8,ATL,CAR,Home,406,478,239,309,3,1,167,169,0,3,1,1
2022-11-06,9,CIN,CAR,Home,464,228,223,164,1,2,241,64,5,1,3,3
2022-11-10,10,CAR,ATL,Home,333,291,101,153,0,2,232,138,2,0,0,0
2022-11-20,11,BAL,CAR,Home,308,205,193,169,0,0,115,36,1,0,3,3
2022-11-27,12,CAR,DEN,Home,349,246,164,125,1,1,185,121,1,0,1,1
2022-12-11,14,SEA,CAR,Away,287,328,241,105,3,1,46,223,0,2,0,0
2022-12-18,15,CAR,PIT,Away,209,325,188,169,1,0,21,156,0,3,0,0
2022-12-24,16,CAR,DET,Home,570,381,250,336,1,3,320,45,3,0,0,0
2023-01-01,17,TAM,CAR,Home,478,400,411,326,3,3,67,74,1,0,3,3
2023-01-08,18,NOR,CAR,Away,304,203,161,32,1,0,143,171,0,0,2,2
2023-09-10,1,ATL,CAR,Home,221,281,91,127,1,1,130,154,2,0,3,3
2023-09-18,2,CAR,NOR,Away,239,341,139,207,1,0,100,134,0,2,1,1
2023-09-24,3,SEA,CAR,Home,425,378,279,334,1,2,146,44,2,1,0,0
2023-10-01,4,CAR,MIN,Away,232,265,149,130,0,2,83,135,0,0,1,1
2023-10-08,5,DET,CAR,Home,377,342,218,243,3,3,159,99,3,0,3,3
2023-10-15,6,MIA,CAR,Home,424,296,262,188,3,1,162,108,3,1,0,0
2023-10-29,8,CAR,HOU,Home,224,229,180,119,1,0,44,110,0,2,0,0
2023-11-05,9,CAR,IND,Away,275,198,137,120,1,1,138,78,0,0,3,3
2023-11-09,10,CHI,CAR,Home,295,213,162,170,0,0,133,43,1,0,0,0
2023-11-19,11,CAR,DAL,Away,187,311,77,204,1,2,110,107,0,1,2,2
2023-11-26,12,TEN,CAR,Home,264,258,184,162,0,0,80,96,2,1,1,1
2023-12-03,13,TAM,CAR,Home,322,282,194,149,1,0,128,133,2,2,1,1
2023-12-10,14,NOR,CAR,Home,207,303,110,99,2,0,97,204,1,0,2,2
2023-12-17,15,CAR,ATL,Home,283,204,154,152,0,1,129,52,0,0,0,0
2023-12-24,16,CAR,GNB,Away,394,369,298,207,2,2,96,162,2,2,0,0
2023-12-31,17,JAX,CAR,Home,317,124,162,67,0,0,155,57,2,0,1,1
2024-01-07,18,CAR,TAM,Away,199,228,68,115,0,0,131,113,0,0,2,2
2014-09-07,1,CHI,BUF,Away,427,360,341,167,2,1,86,193,0,1,3,3
2014-09-14,2,SFO,CHI,Away,359,216,232,170,1,4,127,46,1,0,0,0
2014-09-22,3,NYJ,CHI,Away,414,257,300,197,1,2,114,60,0,0,1,1
2014-09-28,4,CHI,GNB,Away,496,358,261,302,2,4,235,56,0,1,2,2
2014-10-05,5,CAR,CHI,Home,322,347,231,262,2,2,91,85,1,1,4,4
2014-10-12,6,ATL,CHI,Away,287,478,245,375,1,1,42,103,0,2,0,0
2014-10-19,7,CHI,MIA,Away,224,393,172,256,1,2,52,137,1,1,3,3
2014-10-26,8,NWE,CHI,Home,487,384,365,231,5,3,122,153,0,0,2,2
2014-11-09,10,GNB,CHI,Home,451,311,319,256,6,1,132,55,0,0,3,3
2014-11-16,11,CHI,MIN,Home,468,243,330,147,3,1,138,96,0,0,2,2
2014-11-23,12,CHI,TAM,Home,204,367,112,301,1,1,92,66,2,0,1,1
2014-11-27,13,DET,CHI,Home,474,269,383,256,2,2,91,13,2,0,2,2
2014-12-04,14,CHI,DAL,Away,376,397,341,203,2,3,35,194,2,2,2,2
2014-12-15,15,CHI,NOR,Away,278,443,153,360,2,3,125,83,0,1,3,3
2014-12-21,16,CHI,DET,Away,234,367,170,229,2,0,64,138,0,2,1,1
2014-12-28,17,MIN,CHI,Home,311,264,190,165,1,0,121,99,0,0,0,0
2015-09-13,1,CHI,GNB,Away,402,322,213,189,1,3,189,133,1,1,1,1
2015-09-20,2,CHI,ARI,Away,335,300,226,185,1,4,109,115,1,1,2,2
2015-09-27,3,SEA,CHI,Home,371,146,212,48,1,0,159,98,0,0,0,0
2015-10-04,4,CHI,LVR,Home,371,266,273,196,2,2,98,70,0,0,3,3
2015-10-11,5,KAN,CHI,Away,287,328,170,241,1,2,117,87,0,0,1,1
2015-10-18,6,DET,CHI,Home,546,444,391,353,4,1,155,91,0,2,1,1
2015-11-01,8,CHI,MIN,Away,305,327,208,180,1,1,97,147,1,0,0,0
2015-11-09,9,LAC,CHI,Away,339,446,262,337,1,2,77,109,0,1,2,2
2015-11-15,10,LAR,CHI,Away,285,397,191,244,0,3,94,153,1,1,2,2
2015-11-22,11,CHI,DEN,Away,347,389,261,219,0,2,86,170,1,0,2,2
2015-11-26,12,GNB,CHI,Away,365,290,188,189,1,1,177,101,0,1,0,0
2015-12-06,13,CHI,SFO,Away,364,291,194,170,0,1,170,121,2,2,1,1
2015-12-13,14,CHI,WAS,Away,377,374,290,275,2,1,87,99,1,2,1,1
2015-12-20,15,MIN,CHI,Home,350,293,221,199,4,2,129,94,1,0,2,2
2015-12-27,16,TAM,CHI,Away,389,327,285,153,2,1,104,174,1,1,0,0
2016-01-03,17,CHI,DET,Away,342,349,231,282,2,3,111,67,0,0,3,3
2016-09-11,1,HOU,CHI,Home,344,258,215,185,2,1,129,73,0,1,1,1
2016-09-19,2,CHI,PHI,Away,284,280,220,180,0,1,64,100,1,2,3,3
2016-09-25,3,DAL,CHI,Home,447,390,248,312,1,2,199,78,3,0,2,2
2016-10-02,4,CHI,DET,Home,408,263,294,197,2,0,114,66,0,0,0,0
2016-10-09,5,IND,CHI,Home,396,522,298,397,2,2,98,125,0,0,1,1
2016-10-16,6,CHI,JAX,Away,389,317,297,263,0,1,92,54,1,1,0,0
2016-10-20,7,GNB,CHI,Home,406,189,303,120,3,0,103,69,0,0,2,2
2016-10-31,8,CHI,MIN,Home,403,258,245,201,1,1,158,57,1,0,0,0
2016-11-13,10,TAM,CHI,Home,360,283,280,161,2,1,80,122,1,0,4,4
2016-11-20,11,NYG,CHI,Home,329,315,227,222,2,1,102,93,1,1,1,1
2016-11-27,12,CHI,TEN,Away,411,375,316,226,3,2,95,149,0,1,2,2
2016-12-04,13,CHI,SFO,Home,326,147,184,6,0,0,142,141,3,0,1,1
2016-12-11,14,DET,CHI,Home,323,296,209,204,1,1,114,92,1,0,0,0
2016-12-18,15,CHI,GNB,Away,449,451,354,225,2,0,95,226,1,3,4,4
2016-12-24,16,CHI,WAS,Away,458,478,318,270,2,1,140,208,1,4,5,5
2017-01-01,17,MIN,CHI,Home,374,323,250,140,3,1,124,183,1,0,5,5
2017-09-10,1,CHI,ATL,Away,301,372,176,308,1,1,125,64,1,1,0,0
2017-09-17,2,TAM,CHI,Home,311,310,194,290,1,1,117,20,1,0,4,4
2017-09-24,3,CHI,PIT,Home,306,282,84,212,1,1,222,70,2,1,2,2
2017-09-28,4,GNB,CHI,Home,260,308,169,205,4,1,91,103,1,1,4,4
2017-10-09,5,CHI,MIN,Away,274,300,159,141,2,1,115,159,0,1,2,2
2017-10-15,6,BAL,CHI,Away,291,342,166,111,0,2,125,231,0,0,2,2
2017-10-22,7,CHI,CAR,Home,153,293,85,185,0,0,68,108,0,0,0,0
2017-10-29,8,NOR,CHI,Home,387,307,286,150,0,0,101,157,2,1,1,1
2017-11-12,10,CHI,GNB,Away,323,342,268,182,1,1,55,160,0,1,1,1
2017-11-19,11,CHI,DET,Away,398,352,176,287,1,2,222,65,2,0,1,1
2017-11-26,12,PHI,CHI,Home,420,140,244,134,3,0,176,6,0,0,2,2
2017-12-03,13,CHI,SFO,Away,147,388,85,278,1,0,62,110,0,0,0,0
2017-12-10,14,CIN,CHI,Away,234,482,164,250,1,1,70,232,0,3,0,0
2017-12-16,15,DET,CHI,Home,293,349,202,306,2,1,91,43,0,0,3,3
2017-12-24,16,CHI,CLE,Home,258,254,161,178,0,0,97,76,3,0,0,0
2017-12-31,17,MIN,CHI,Home,327,201,180,171,1,0,147,30,2,0,0,0
2018-09-09,1,GNB,CHI,Home,370,294,301,155,3,0,69,139,0,1,1,1
2018-09-17,2,CHI,SEA,Home,271,276,185,202,2,2,86,74,0,0,2,2
2018-09-23,3,ARI,CHI,Away,221,316,168,194,2,0,53,122,0,1,2,2
2018-09-30,4,CHI,TAM,Home,483,311,344,251,6,1,139,60,0,0,0,0
2018-10-14,6,MIA,CHI,Home,541,467,380,303,3,3,161,164,0,1,3,3
2018-10-21,7,CHI,NWE,Away,453,381,319,273,2,3,134,108,2,0,2,2
2018-10-28,8,CHI,NYJ,Home,395,207,216,150,2,1,179,57,1,0,0,0
2018-11-04,9,BUF,CHI,Away,264,190,166,126,0,1,98,64,1,2,1,1
2018-11-11,10,CHI,DET,Home,402,305,348,229,3,2,54,76,2,1,0,0
2018-11-18,11,CHI,MIN,Home,308,268,160,246,1,2,148,22,0,0,3,3
2018-11-22,12,DET,CHI,Away,333,264,222,226,0,2,111,38,2,0,1,1
2018-12-02,13,NYG,CHI,Home,338,376,197,258,2,2,141,118,0,1,3,3
2018-12-09,14,CHI,LAR,Home,294,214,100,162,1,0,194,52,0,0,3,3
2018-12-16,15,CHI,GNB,Home,332,323,232,235,2,0,100,88,1,1,1,1
2018-12-23,16,SFO,CHI,Away,279,325,232,235,0,1,47,90,0,1,2,2
2018-12-30,17,MIN,CHI,Away,164,332,101,163,1,0,63,169,0,3,0,0
2019-09-05,1,CHI,GNB,Away,254,213,208,166,0,1,46,47,0,0,1,1
2019-09-15,2,DEN,CHI,Away,372,273,282,120,1,0,90,153,0,1,0,0
2019-09-23,3,WAS,CHI,Away,356,298,287,208,2,3,69,90,0,0,1,1
2019-09-29,4,CHI,MIN,Home,269,222,197,182,1,0,72,40,0,1,0,0
2019-10-06,5,LVR,CHI,Home,398,236,229,194,0,2,169,42,3,1,2,2
2019-10-20,7,CHI,NOR,Away,252,424,235,273,2,2,17,151,0,2,2,2
2019-10-27,8,CHI,LAC,Away,388,231,226,195,0,1,162,36,1,1,2,2
2019-11-03,9,PHI,CHI,Home,373,164,227,102,1,0,146,62,1,2,1,1
2019-11-10,10,CHI,DET,Home,226,357,145,259,3,1,81,98,0,0,0,0
2019-11-17,11,LAR,CHI,Home,283,267,173,193,0,1,110,74,2,0,1,1
2019-11-24,12,CHI,NYG,Home,335,243,270,134,1,2,65,109,1,0,2,2
2019-11-28,13,DET,CHI,Away,364,419,259,331,2,3,105,88,0,0,1,1
2019-12-05,14,CHI,DAL,Home,382,408,231,326,3,1,151,82,1,2,2,2
2019-12-15,15,GNB,CHI,Home,292,415,192,319,1,1,100,96,2,0,3,3
2019-12-22,16,CHI,KAN,Away,234,350,133,244,0,2,101,106,0,1,0,0
2019-12-29,17,MIN,CHI,Away,300,337,126,179,0,0,174,158,1,1,1,1
2020-09-13,1,DET,CHI,Away,426,363,288,214,1,3,138,149,1,0,0,0
2020-09-20,2,CHI,NYG,Home,304,295,169,220,2,0,135,75,0,1,2,2
2020-09-27,3,ATL,CHI,Away,371,437,227,307,1,4,144,130,2,0,2,2
2020-10-04,4,CHI,IND,Away,269,289,241,186,1,1,28,103,0,0,1,1
2020-10-08,5,CHI,TAM,Home,243,339,208,233,1,1,35,106,1,0,1,1
2020-10-18,6,CAR,CHI,Away,303,261,191,198,0,1,112,63,1,1,1,1
2020-10-26,7,LAR,CHI,Home,371,279,211,230,2,0,160,49,1,0,2,2
2020-11-01,8,CHI,NOR,Away,329,394,233,272,2,2,96,122,0,0,1,1
2020-11-08,9,TEN,CHI,Home,228,375,136,319,2,2,92,56,0,0,2,2
2020-11-16,10,CHI,MIN,Away,149,385,108,286,0,2,41,99,0,0,2,2
2020-11-29,12,GNB,CHI,Home,393,350,211,229,4,3,182,121,1,0,3,3
2020-12-06,13,CHI,DET,Away,389,460,249,400,1,3,140,60,3,2,1,1
2020-12-13,14,CHI,HOU,Home,410,263,241,155,3,1,169,108,1,0,0,0
2020-12-20,15,MIN,CHI,Away,407,397,249,198,2,1,158,199,1,2,1,1
2020-12-27,16,JAX,CHI,Away,279,391,203,263,2,2,76,128,0,3,1,1
2021-01-03,17,CHI,GNB,Away,356,316,248,237,0,4,108,79,1,1,2,2
2021-09-12,1,LAR,CHI,Home,386,322,312,188,3,0,74,134,1,2,2,2
2021-09-19,2,CHI,CIN,Home,206,248,83,179,1,2,123,69,0,0,1,1
2021-09-26,3,CLE,CHI,Home,418,47,203,1,1,0,215,46,1,0,0,0
2021-10-03,4,CHI,DET,Home,373,351,185,261,0,2,188,90,3,0,1,1
2021-10-10,5,LVR,CHI,Away,259,252,188,109,0,1,71,143,1,1,0,0
2021-10-17,6,CHI,GNB,Away,277,323,137,169,1,2,140,154,1,1,1,1
2021-10-24,7,TAM,CHI,Home,408,311,226,168,4,0,182,143,1,0,5,5
2021-10-31,8,CHI,SFO,Away,324,467,148,322,1,0,176,145,1,3,1,1
2021-11-08,9,PIT,CHI,Home,280,414,175,278,2,1,105,136,1,1,2,2
2021-11-21,11,CHI,BAL,Away,353,299,261,176,2,0,92,123,0,1,1,1
2021-11-25,12,DET,CHI,Away,239,378,163,310,2,1,76,68,0,0,1,1
2021-12-05,13,CHI,ARI,Away,329,257,217,120,2,2,112,137,1,2,4,4
2021-12-12,14,GNB,CHI,Home,439,347,320,210,4,2,119,137,1,0,3,3
2021-12-20,15,CHI,MIN,Away,370,193,255,61,1,2,115,132,0,0,3,3
2021-12-26,16,SEA,CHI,Away,331,317,161,229,2,1,170,88,1,2,0,0
2022-01-09,18,MIN,CHI,Home,331,356,227,266,3,1,104,90,0,0,2,2
2022-09-11,1,CHI,SFO,Home,204,331,105,155,2,0,99,176,1,1,1,1
2022-09-18,2,GNB,CHI,Home,414,228,211,48,2,0,203,180,1,1,1,1
2022-09-25,3,CHI,HOU,Home,363,329,82,237,0,1,281,92,2,1,2,2
2022-10-02,4,NYG,CHI,Home,333,304,71,155,0,0,262,149,2,0,3,3
2022-10-09,5,MIN,CHI,Home,429,271,312,193,1,1,117,78,3,1,1,1
2022-10-13,6,CHI,WAS,Away,391,214,154,86,1,0,237,128,0,1,2,2
2022-10-24,7,NWE,CHI,Away,260,390,190,147,1,1,70,243,1,2,1,1
2022-10-30,8,DAL,CHI,Home,442,371,242,131,2,2,200,240,4,2,1,1
2022-11-06,9,CHI,MIA,Away,368,379,116,302,3,3,252,77,1,1,0,0
2022-11-13,10,CHI,DET,Away,408,323,150,228,2,1,258,95,2,2,1,1
2022-11-20,11,ATL,CHI,Home,280,288,131,128,1,1,149,160,1,2,1,1
2022-11-27,12,NYJ,CHI,Home,466,292,308,165,3,1,158,127,1,0,1,1
2022-12-04,13,CHI,GNB,Away,409,357,254,182,0,1,155,175,2,2,3,3
2022-12-18,15,CHI,PHI,Away,248,421,91,309,2,0,157,112,1,3,1,1
2022-12-24,16,CHI,BUF,Away,209,426,129,172,1,2,80,254,0,3,2,2
2023-01-01,17,DET,CHI,Home,504,230,239,30,3,1,265,200,2,0,2,2
2023-01-08,18,CHI,MIN,Away,259,482,141,341,1,1,118,141,1,2,2,2
2023-09-10,1,CHI,GNB,Away,311,329,189,237,1,3,122,92,1,1,2,2
2023-09-17,2,TAM,CHI,Home,437,236,317,169,1,1,120,67,1,1,2,2
2023-09-24,3,KAN,CHI,Home,456,203,303,87,3,1,153,116,2,0,2,2
2023-10-01,4,CHI,DEN,Away,471,311,300,214,4,3,171,97,0,0,2,2
2023-10-05,5,WAS,CHI,Away,388,451,359,273,2,4,29,178,0,0,0,0
2023-10-15,6,CHI,MIN,Away,275,220,113,174,0,1,162,46,1,0,3,3
2023-10-22,7,CHI,LVR,Home,323,235,150,196,1,1,173,39,2,0,0,0
2023-10-29,8,LAC,CHI,Home,352,295,298,222,3,0,54,73,0,2,2,2
2023-11-05,9,NOR,CHI,Home,301,368,214,212,3,2,87,156,0,0,5,5
2023-11-09,10,CHI,CAR,Home,295,213,162,170,0,0,133,43,1,0,0,0
2023-11-19,11,DET,CHI,Home,338,334,223,151,2,1,115,183,2,1,1,1
2023-11-27,12,MIN,CHI,Away,242,317,169,199,1,0,73,118,0,0,2,2
2023-12-10,14,CHI,DET,Home,336,267,194,127,1,1,142,140,2,1,0,0
2023-12-17,15,CLE,CHI,Home,377,236,348,148,2,1,29,88,0,0,3,3
2023-12-24,16,CHI,ARI,Home,420,306,170,213,1,2,250,93,2,0,1,1
2023-12-31,17,CHI,ATL,Home,432,307,240,173,1,1,192,134,3,1,0,0
2024-01-07,18,GNB,CHI,Home,432,192,308,117,2,0,124,75,0,0,0,0
2014-09-07,1,BAL,CIN,Away,423,380,329,301,1,1,94,79,1,0,0,0
2014-09-14,2,CIN,ATL,Home,472,309,302,212,1,1,170,97,2,0,0,0
2014-09-21,3,CIN,TEN,Home,300,326,184,177,1,0,116,149,3,1,1,1
2014-10-05,5,NWE,CIN,Home,505,320,285,241,2,2,220,79,1,0,3,3
2014-10-12,6,CIN,CAR,Away,513,431,320,284,2,2,193,147,2,2,2,2
2014-10-19,7,IND,CIN,Home,506,135,335,103,2,0,171,32,1,0,0,0
2014-10-26,8,CIN,BAL,Home,350,294,239,187,0,0,111,107,3,2,2,2
2014-11-02,9,CIN,JAX,Home,423,365,232,233,2,2,191,132,2,1,2,2
2014-11-06,10,CIN,CLE,Away,165,368,79,198,0,0,86,170,0,3,4,4
2014-11-16,11,NOR,CIN,Away,330,405,255,219,1,3,75,186,0,0,0,0
2014-11-23,12,HOU,CIN,Away,248,372,184,233,0,1,64,139,0,1,1,1
2014-11-30,13,TAM,CIN,Away,263,288,188,176,0,1,75,112,1,1,3,3
2014-12-07,14,CIN,PIT,Away,408,543,322,350,2,3,86,193,1,2,2,2
2014-12-14,15,CLE,CIN,Away,107,347,54,103,0,0,53,244,0,3,1,1
2014-12-22,16,CIN,DEN,Home,353,385,146,300,2,2,207,85,1,1,2,2
2014-12-28,17,PIT,CIN,Home,346,337,317,221,2,2,29,116,0,0,3,3
2015-09-13,1,LVR,CIN,Away,246,396,183,269,2,2,63,127,0,2,0,0
2015-09-20,2,CIN,LAC,Home,389,354,214,223,3,2,175,131,0,0,2,2
2015-09-27,3,BAL,CIN,Away,398,458,362,372,2,3,36,86,0,1,2,2
2015-10-04,4,CIN,KAN,Home,445,461,321,348,1,0,124,113,4,0,0,0
2015-10-11,5,CIN,SEA,Home,419,397,310,197,2,1,109,200,1,1,2,2
2015-10-18,6,BUF,CIN,Away,368,355,256,243,1,3,112,112,2,1,0,0
2015-11-01,8,PIT,CIN,Away,356,296,240,218,1,1,116,78,0,0,2,2
2015-11-05,9,CIN,CLE,Home,371,213,219,144,3,1,152,69,1,0,0,0
2015-11-16,10,CIN,HOU,Away,256,256,182,174,0,1,74,82,0,0,2,2
2015-11-22,11,ARI,CIN,Home,383,377,301,278,4,2,82,99,0,2,1,1
2015-11-29,12,CIN,LAR,Home,376,345,236,251,3,0,140,94,0,1,1,1
2015-12-06,13,CLE,CIN,Away,273,377,205,233,0,2,68,144,0,2,0,0
2015-12-13,14,CIN,PIT,Away,385,354,321,270,2,0,64,84,0,2,3,3
2015-12-20,15,SFO,CIN,Away,318,242,263,174,1,1,55,68,1,2,1,1
2015-12-28,16,DEN,CIN,Home,390,294,277,186,1,1,113,108,1,1,1,1
2016-01-03,17,CIN,BAL,Home,292,341,147,282,2,1,145,59,1,0,0,0
2016-09-11,1,NYJ,CIN,Away,340,381,188,324,2,1,152,57,0,1,1,1
2016-09-18,2,PIT,CIN,Home,374,412,250,366,3,1,124,46,0,0,2,2
2016-09-25,3,CIN,DEN,Away,332,355,189,303,0,4,143,52,2,0,2,2
2016-09-29,4,CIN,MIA,Home,362,222,285,160,1,1,77,62,0,0,0,0
2016-10-09,5,DAL,CIN,Home,402,345,222,249,1,2,180,96,3,0,0,0
2016-10-16,6,NWE,CIN,Home,437,357,358,237,3,1,79,120,1,1,0,0
2016-10-23,7,CIN,CLE,Home,559,352,288,172,2,0,271,180,2,2,1,1
2016-10-30,8,CIN,WAS,Away,415,546,263,446,1,2,152,100,3,1,2,2
2016-11-14,10,NYG,CIN,Home,351,264,229,186,3,1,122,78,0,1,1,1
2016-11-20,11,CIN,BUF,Away,300,342,207,159,1,0,93,183,1,1,2,2
2016-11-27,12,BAL,CIN,Home,311,325,219,261,1,1,92,64,0,0,2,2
2016-12-04,13,CIN,PHI,Home,412,359,332,306,2,1,80,53,1,1,2,2
2016-12-11,14,CLE,CIN,Away,254,360,85,147,0,2,169,213,1,1,0,0
2016-12-18,15,CIN,PIT,Away,222,382,146,285,0,1,76,97,2,0,1,1
2016-12-24,16,HOU,CIN,Home,250,294,155,244,0,1,95,50,1,0,1,1
2017-01-01,17,CIN,BAL,Home,371,335,218,263,1,0,153,72,2,1,0,0
2017-09-10,1,CIN,BAL,Away,221,268,144,111,0,1,77,157,0,1,5,5
2017-09-14,2,CIN,HOU,Away,295,266,213,98,0,0,82,168,0,1,1,1
2017-09-24,3,GNB,CIN,Home,344,301,280,191,3,2,64,110,0,0,1,1
2017-10-01,4,CLE,CIN,Away,215,350,170,264,0,4,45,86,1,0,1,1
2017-10-08,5,CIN,BUF,Home,388,221,323,139,1,1,65,82,1,0,3,3
2017-10-22,7,PIT,CIN,Home,420,179,268,108,2,2,152,71,0,0,2,2
2017-10-29,8,CIN,IND,Home,276,331,218,216,2,2,58,115,0,0,2,2
2017-11-05,9,JAX,CIN,Home,408,148,259,119,1,0,149,29,0,1,0,0
2017-11-12,10,TEN,CIN,Home,416,308,236,255,1,2,180,53,2,1,2,2
2017-11-19,11,DEN,CIN,Away,341,190,229,141,1,3,112,49,1,0,0,0
2017-11-26,12,CIN,CLE,Home,361,405,209,236,2,0,152,169,1,1,0,0
2017-12-04,13,CIN,PIT,Away,353,374,223,282,2,2,130,92,0,0,0,0
2017-12-10,14,CIN,CHI,Away,234,482,164,250,1,1,70,232,0,3,2,2
2017-12-17,15,MIN,CIN,Home,346,161,222,115,2,0,124,46,1,1,2,2
2017-12-24,16,CIN,DET,Home,364,276,222,189,1,1,142,87,1,1,1,1
2017-12-31,17,BAL,CIN,Away,312,359,194,213,2,3,118,146,1,0,1,1
2018-09-09,1,IND,CIN,Away,380,330,305,229,2,2,75,101,0,1,2,2
2018-09-13,2,CIN,BAL,Home,373,425,265,359,4,2,108,66,0,1,0,0
2018-09-23,3,CAR,CIN,Home,377,396,147,330,2,2,230,66,2,1,4,4
2018-09-30,4,ATL,CIN,Away,495,407,403,308,3,3,92,99,1,2,1,1
2018-10-07,5,CIN,MIA,Home,332,297,229,169,1,1,103,128,0,0,1,1
2018-10-14,6,CIN,PIT,Away,275,481,213,369,2,1,62,112,1,2,0,0
2018-10-21,7,KAN,CIN,Home,551,239,353,174,4,1,198,65,1,0,1,1
2018-10-28,8,CIN,TAM,Home,402,576,264,450,2,3,138,126,2,1,0,0
2018-11-11,10,CIN,NOR,Away,284,509,174,265,1,3,110,244,1,3,2,2
2018-11-18,11,BAL,CIN,Home,403,255,136,207,0,2,267,48,2,1,0,0
2018-11-25,12,CIN,CLE,Away,372,342,243,258,2,4,129,84,1,1,2,2
2018-12-02,13,CIN,DEN,Away,313,361,202,143,1,1,111,218,0,2,3,3
2018-12-09,14,LAC,CIN,Home,288,295,203,151,1,1,85,144,1,1,0,0
2018-12-16,15,CIN,LVR,Home,294,297,123,229,1,1,171,68,2,0,1,1
2018-12-23,16,CLE,CIN,Home,493,209,347,107,3,2,146,102,0,0,0,0
2018-12-30,17,PIT,CIN,Home,343,196,278,71,1,0,65,125,0,0,0,0
2019-09-08,1,SEA,CIN,Home,232,429,160,395,2,2,72,34,1,0,3,3
2019-09-15,2,CIN,SFO,Away,316,571,291,312,2,3,25,259,0,2,1,1
2019-09-22,3,BUF,CIN,Home,416,306,241,240,1,1,175,66,1,1,4,4
2019-09-30,4,PIT,CIN,Home,326,175,260,102,2,0,66,73,1,0,2,2
2019-10-06,5,CIN,ARI,Away,370,514,262,248,2,0,108,266,0,2,0,0
2019-10-13,6,BAL,CIN,Home,497,250,228,217,0,0,269,33,2,1,1,1
2019-10-20,7,CIN,JAX,Away,291,460,258,244,1,1,33,216,1,0,4,4
2019-10-27,8,LAR,CIN,Home,470,401,372,297,2,1,98,104,1,0,0,0
2019-11-10,10,CIN,BAL,Away,307,379,150,243,1,3,157,136,0,2,3,3
2019-11-17,11,LVR,CIN,Home,386,246,273,73,1,0,113,173,1,1,2,2
2019-11-24,12,CIN,PIT,Away,244,338,158,179,1,1,86,159,0,0,2,2
2019-12-01,13,CIN,NYJ,Home,277,271,233,209,1,0,44,62,1,0,0,0
2019-12-08,14,CLE,CIN,Home,333,451,187,272,0,0,146,179,2,1,1,1
2019-12-15,15,CIN,NWE,Away,315,291,151,116,1,2,164,175,0,1,5,5
2019-12-22,16,MIA,CIN,Home,502,430,406,371,4,4,96,59,1,0,1,1
2019-12-29,17,CIN,CLE,Home,361,313,182,239,1,3,179,74,3,0,1,1
2020-09-13,1,CIN,LAC,Away,295,362,173,207,0,0,122,155,1,1,2,2
2020-09-17,2,CLE,CIN,Home,434,353,219,285,2,3,215,68,3,0,1,1
2020-09-27,3,PHI,CIN,Home,378,304,206,256,1,2,172,48,1,0,0,0
2020-10-04,4,CIN,JAX,Home,505,429,300,340,1,2,205,89,2,0,1,1
2020-10-11,5,BAL,CIN,Home,332,205,171,135,2,0,161,70,0,0,3,3
2020-10-18,6,IND,CIN,Home,430,398,371,300,3,0,59,98,1,3,1,1
2020-10-25,7,CIN,CLE,Away,468,398,387,316,3,5,81,82,1,0,2,2
2020-11-01,8,CIN,TEN,Home,367,441,249,223,2,2,118,218,2,1,0,0
2020-11-15,10,PIT,CIN,Home,377,324,333,185,4,1,44,139,0,0,2,2
2020-11-22,11,WAS,CIN,Home,325,272,161,202,1,1,164,70,1,0,2,2
2020-11-29,12,CIN,NYG,Away,155,386,115,244,1,0,40,142,0,1,3,3
2020-12-06,13,MIA,CIN,Home,406,196,296,156,1,1,110,40,0,0,2,2
2020-12-13,14,CIN,DAL,Away,309,272,208,171,1,2,101,101,0,0,3,3
2020-12-21,15,CIN,PIT,Home,230,244,78,158,1,1,152,86,2,1,0,0
2020-12-27,16,HOU,CIN,Away,488,540,322,371,3,2,166,169,1,2,0,0
2021-01-03,17,CIN,BAL,Away,195,525,48,121,0,3,147,404,0,2,2,2
2021-09-12,1,CIN,MIN,Home,366,403,217,336,2,2,149,67,1,1,0,0
2021-09-19,2,CHI,CIN,Home,206,248,83,179,1,2,123,69,0,0,4,4
2021-09-26,3,PIT,CIN,Away,342,268,297,172,1,3,45,96,0,0,1,1
2021-09-30,4,CIN,JAX,Home,420,341,342,202,2,0,78,139,1,3,0,0
2021-10-10,5,CIN,GNB,Away,367,466,264,333,2,2,103,133,1,0,2,2
2021-10-17,6,DET,CIN,Away,228,398,192,256,0,4,36,142,1,0,1,1
2021-10-24,7,BAL,CIN,Away,393,520,278,409,1,3,115,111,1,2,1,1
2021-10-31,8,NYJ,CIN,Home,511,318,414,277,3,3,97,41,1,1,1,1
2021-11-07,9,CIN,CLE,Away,348,361,263,208,0,2,85,153,2,2,3,3
2021-11-21,11,LVR,CIN,Away,278,288,206,129,1,1,72,159,0,2,1,1
2021-11-28,12,CIN,PIT,Home,370,301,172,250,1,1,198,51,3,0,1,1
2021-12-05,13,CIN,LAC,Away,356,363,260,284,1,3,96,79,2,1,4,4
2021-12-12,14,CIN,SFO,Away,397,355,311,255,2,2,86,100,0,1,2,2
2021-12-19,15,DEN,CIN,Away,292,249,159,136,1,1,133,113,0,0,0,0
2021-12-26,16,CIN,BAL,Home,575,334,498,295,4,2,77,39,1,1,0,0
2022-01-02,17,CIN,KAN,Home,475,414,415,259,4,2,60,155,0,2,0,0
2022-01-09,18,CLE,CIN,Home,376,182,171,103,2,1,205,79,1,0,0,0
2022-09-11,1,CIN,PIT,Away,432,267,299,192,2,1,133,75,0,0,5,5
2022-09-18,2,DAL,CIN,Home,337,254,230,165,1,1,107,89,1,0,0,0
2022-09-25,3,NYJ,CIN,Away,328,330,252,261,0,3,76,69,0,0,1,1
2022-09-29,4,CIN,MIA,Home,371,378,304,293,2,1,67,85,1,0,0,0
2022-10-09,5,BAL,CIN,Home,325,291,170,190,1,1,155,101,0,1,1,1
2022-10-16,6,NOR,CIN,Away,399,348,171,273,1,3,228,75,1,1,1,1
2022-10-23,7,CIN,ATL,Home,537,214,459,107,3,1,78,107,2,1,0,0
2022-10-31,8,CLE,CIN,Home,440,229,268,193,1,2,172,36,3,0,2,2
2022-11-06,9,CIN,CAR,Home,464,228,223,164,1,2,241,64,5,1,0,0
2022-11-20,11,PIT,CIN,Away,351,408,249,346,1,4,102,62,2,0,2,2
2022-11-27,12,TEN,CIN,Away,344,374,281,266,0,1,63,108,0,1,0,0
2022-12-04,13,CIN,KAN,Home,431,349,279,211,2,1,152,138,1,2,0,0
2022-12-11,14,CIN,CLE,Home,363,344,227,273,2,1,136,71,1,0,1,1
2022-12-18,15,TAM,CIN,Away,396,237,304,184,3,4,92,53,0,0,1,1
2022-12-24,16,NWE,CIN,Away,285,442,224,369,2,3,61,73,0,0,3,3
2023-01-08,18,CIN,BAL,Home,257,386,202,276,1,0,55,110,1,1,1,1
2023-09-10,1,CLE,CIN,Home,350,142,144,67,1,0,206,75,1,0,0,0
2023-09-17,2,CIN,BAL,Away,282,415,216,237,2,2,66,178,0,1,1,1
2023-09-25,3,CIN,LAR,Home,309,292,242,221,0,1,67,71,1,0,1,1
2023-10-01,4,TEN,CIN,Home,400,211,227,139,2,0,173,72,1,0,1,1
2023-10-08,5,ARI,CIN,Away,294,380,152,287,2,3,142,93,1,0,1,1
2023-10-15,6,CIN,SEA,Home,214,384,168,297,2,0,46,87,0,1,1,1
2023-10-29,8,SFO,CIN,Away,460,400,347,266,1,3,113,134,1,1,1,1
2023-11-05,9,CIN,BUF,Home,397,317,343,249,2,1,54,68,1,1,0,0
2023-11-12,10,CIN,HOU,Away,380,544,314,356,2,1,66,188,1,2,2,2
2023-11-16,11,BAL,CIN,Home,405,272,248,136,2,2,157,136,2,0,0,0
2023-11-26,12,CIN,PIT,Away,222,421,197,268,1,0,25,153,0,1,1,1
2023-12-04,13,JAX,CIN,Away,376,491,305,335,2,1,71,156,2,3,1,1
2023-12-10,14,CIN,IND,Home,385,272,274,226,2,1,111,46,2,0,1,1
2023-12-16,15,CIN,MIN,Home,378,424,298,281,2,2,80,143,1,1,1,1
2023-12-23,16,PIT,CIN,Home,397,368,284,309,2,1,113,59,2,0,3,3
2023-12-31,17,KAN,CIN,Home,373,263,241,159,1,1,132,104,0,1,0,0
2024-01-07,18,CIN,CLE,Home,328,244,145,140,3,2,183,104,1,0,1,1
2014-09-07,1,PIT,CLE,Home,503,389,376,198,1,1,127,191,2,2,0,0
2014-09-14,2,CLE,NOR,Home,324,397,202,223,1,2,122,174,1,1,0,0
2014-09-21,3,CLE,BAL,Away,375,377,290,217,1,1,85,160,2,1,0,0
2014-10-05,5,TEN,CLE,Away,410,460,261,284,3,3,149,176,1,0,1,1
2014-10-12,6,CLE,PIT,Home,368,359,210,221,1,1,158,138,3,0,1,1
2014-10-19,7,JAX,CLE,Home,336,266,151,197,1,0,185,69,2,0,3,3
2014-10-26,8,CLE,LVR,Home,306,387,267,311,1,1,39,76,1,0,0,0
2014-11-02,9,CLE,TAM,Home,330,365,274,252,2,2,56,113,0,0,2,2
2014-11-06,10,CIN,CLE,Away,165,368,79,198,0,0,86,170,0,3,1,1
2014-11-16,11,CLE,HOU,Away,375,424,310,211,1,2,65,213,0,0,2,2
2014-11-23,12,ATL,CLE,Away,315,475,252,313,2,0,63,162,1,2,3,3
2014-11-30,13,BUF,CLE,Home,287,315,181,241,1,0,106,74,0,1,3,3
2014-12-07,14,CLE,IND,Away,248,362,133,269,0,2,115,93,1,1,2,2
2014-12-14,15,CLE,CIN,Away,107,347,54,103,0,0,53,244,0,3,2,2
2014-12-21,16,CAR,CLE,Home,404,228,195,144,1,1,209,84,1,0,1,1
2014-12-28,17,BAL,CLE,Home,419,259,290,150,2,0,129,109,0,1,2,2
2015-09-13,1,NYJ,CLE,Home,333,321,179,217,2,1,154,104,2,0,5,5
2015-09-20,2,CLE,TEN,Home,274,385,158,219,2,2,116,166,1,0,0,0
2015-09-27,3,CLE,LVR,Away,355,469,316,314,2,2,39,155,0,1,2,2
2015-10-04,4,LAC,CLE,Home,438,432,347,332,3,2,91,100,0,0,1,1
2015-10-11,5,BAL,CLE,Away,377,505,196,422,1,2,181,83,3,1,0,0
2015-10-18,6,CLE,DEN,Away,298,442,189,290,2,1,109,152,0,0,3,3
2015-10-25,7,LAR,CLE,Home,308,364,150,282,0,0,158,82,2,0,4,4
2015-11-01,8,CLE,ARI,Away,254,491,215,372,3,4,39,119,0,0,2,2
2015-11-05,9,CIN,CLE,Home,371,213,219,144,3,1,152,69,1,0,0,0
2015-11-15,10,PIT,CLE,Home,459,342,399,327,3,1,60,15,0,0,3,3
2015-11-30,12,CLE,BAL,Away,338,336,275,232,2,2,63,104,0,0,0,0
2015-12-06,13,CLE,CIN,Away,273,377,205,233,0,2,68,144,0,2,2,2
2015-12-13,14,CLE,SFO,Home,481,221,251,150,1,1,230,71,2,0,2,2
2015-12-20,15,SEA,CLE,Home,423,230,241,136,3,1,182,94,0,0,1,1
2015-12-27,16,KAN,CLE,Home,258,368,122,136,2,0,136,232,0,1,1,1
2016-01-03,17,CLE,PIT,Away,263,379,177,349,0,3,86,30,0,0,4,4
2016-09-11,1,PHI,CLE,Home,403,288,270,168,2,0,133,120,1,1,1,1
2016-09-18,2,CLE,BAL,Away,387,382,242,302,2,2,145,80,1,0,2,2
2016-09-25,3,MIA,CLE,Home,426,430,311,261,3,0,115,169,1,1,1,1
2016-10-02,4,WAS,CLE,Home,301,380,156,217,3,1,145,163,1,1,3,3
2016-10-09,5,CLE,NWE,Away,262,501,235,403,2,3,27,98,0,1,1,1
2016-10-16,6,TEN,CLE,Home,407,341,270,301,3,2,137,40,1,1,0,0
2016-10-23,7,CIN,CLE,Home,559,352,288,172,2,0,271,180,2,2,2,2
2016-10-30,8,CLE,NYJ,Away,407,393,339,222,2,1,68,171,1,3,2,2
2016-11-06,9,CLE,DAL,Away,222,423,177,255,1,3,45,168,0,2,0,0
2016-11-10,10,BAL,CLE,Home,396,144,277,111,3,1,119,33,0,0,3,3
2016-11-20,11,CLE,PIT,Away,209,313,176,167,1,0,33,146,0,1,2,2
2016-11-27,12,CLE,NYG,Away,343,296,285,192,1,3,58,104,0,0,3,3
2016-12-11,14,CLE,CIN,Away,254,360,85,147,0,2,169,213,1,1,1,1
2016-12-18,15,BUF,CLE,Home,451,269,171,162,1,0,280,107,3,1,0,0
2016-12-24,16,CLE,LAC,Home,251,356,127,322,0,2,124,34,2,0,0,0
2017-01-01,17,PIT,CLE,Home,312,437,243,206,3,2,69,231,1,1,4,4
2017-09-10,1,CLE,PIT,Away,237,290,180,255,1,2,57,35,1,0,1,1
2017-09-17,2,BAL,CLE,Home,337,386,201,293,2,1,136,93,1,0,5,5
2017-09-24,3,IND,CLE,Home,335,346,243,235,1,2,92,111,3,2,3,3
2017-10-01,4,CLE,CIN,Away,215,350,170,264,0,4,45,86,1,0,1,1
2017-10-08,5,CLE,NYJ,Away,419,212,279,178,2,2,140,34,0,0,3,3
2017-10-15,6,HOU,CLE,Home,340,247,217,113,3,1,123,134,0,0,3,3
2017-10-22,7,CLE,TEN,Away,284,269,218,189,0,0,66,80,0,0,3,3
2017-10-29,8,CLE,MIN,Away,276,375,161,287,0,2,115,88,2,1,2,2
2017-11-12,10,DET,CLE,Home,345,413,241,212,3,1,104,201,1,2,2,2
2017-11-19,11,CLE,JAX,Away,184,284,134,145,1,1,50,139,0,0,5,5
2017-11-26,12,CIN,CLE,Home,361,405,209,236,2,0,152,169,1,1,0,0
2017-12-03,13,LAC,CLE,Home,429,291,335,202,1,1,94,89,0,0,2,2
2017-12-10,14,CLE,GNB,Away,345,341,209,256,3,3,136,85,0,1,2,2
2017-12-17,15,CLE,BAL,Away,266,376,136,279,0,1,130,97,1,1,4,4
2017-12-24,16,CHI,CLE,Home,258,254,161,178,0,0,97,76,3,0,3,3
2017-12-31,17,PIT,CLE,Home,348,374,224,272,1,2,124,102,2,1,2,2
2018-09-09,1,CLE,PIT,Away,327,472,150,313,1,1,177,159,2,2,1,1
2018-09-16,2,NOR,CLE,Home,275,327,213,234,2,1,62,93,0,1,1,1
2018-09-20,3,CLE,NYJ,Home,323,268,190,161,0,0,133,107,2,2,0,0
2018-09-30,4,LVR,CLE,Home,565,487,426,279,4,2,139,208,0,3,4,4
2018-10-07,5,CLE,BAL,Home,416,410,304,294,1,0,112,116,0,0,1,1
2018-10-14,6,CLE,LAC,Away,317,449,214,203,1,2,103,246,0,3,2,2
2018-10-21,7,TAM,CLE,Home,456,305,342,186,0,2,114,119,3,1,1,1
2018-10-28,8,PIT,CLE,Home,421,237,253,163,2,2,168,74,2,0,1,1
2018-11-04,9,CLE,KAN,Away,388,499,286,360,2,3,102,139,1,2,1,1
2018-11-11,10,CLE,ATL,Home,427,382,216,311,3,2,211,71,1,0,1,1
2018-11-25,12,CIN,CLE,Away,372,342,243,258,2,4,129,84,1,1,0,0
2018-12-02,13,HOU,CLE,Home,384,428,197,397,1,1,187,31,0,1,4,4
2018-12-09,14,CLE,CAR,Home,348,393,232,297,1,0,116,96,2,2,2,2
2018-12-15,15,DEN,CLE,Away,270,309,238,175,0,2,32,134,1,0,2,2
2018-12-23,16,CLE,CIN,Home,493,209,347,107,3,2,146,102,0,0,0,0
2018-12-30,17,BAL,CLE,Home,463,426,167,376,0,3,296,50,2,0,3,3
2019-09-08,1,CLE,TEN,Away,346,339,244,216,1,3,102,123,1,1,3,3
2019-09-16,2,NYJ,CLE,Away,262,375,169,305,0,1,93,70,0,1,1,1
2019-09-22,3,CLE,LAR,Away,270,344,175,254,1,2,95,90,0,0,1,1
2019-09-29,4,BAL,CLE,Away,395,530,222,337,3,1,173,193,0,4,1,1
2019-10-07,5,SFO,CLE,Home,446,180,171,78,2,0,275,102,2,0,4,4
2019-10-13,6,CLE,SEA,Away,406,454,249,284,1,2,157,170,3,2,4,4
2019-10-27,8,NWE,CLE,Home,318,310,239,151,2,1,79,159,0,0,3,3
2019-11-03,9,DEN,CLE,Home,302,351,175,261,2,1,127,90,1,0,0,0
2019-11-10,10,CLE,BUF,Home,368,344,221,260,2,0,147,84,0,2,0,0
2019-11-14,11,CLE,PIT,Home,293,236,189,178,2,1,104,58,1,0,0,0
2019-11-24,12,CLE,MIA,Home,467,284,320,192,3,2,147,92,2,1,1,1
2019-12-01,13,PIT,CLE,Home,323,279,199,173,1,1,124,106,1,0,2,2
2019-12-08,14,CLE,CIN,Home,333,451,187,272,0,0,146,179,2,1,2,2
2019-12-15,15,ARI,CLE,Home,445,393,219,241,1,2,226,152,4,1,2,2
2019-12-22,16,CLE,BAL,Away,241,481,184,238,2,3,57,243,0,1,1,1
2019-12-29,17,CIN,CLE,Home,361,313,182,239,1,3,179,74,3,0,3,3
2020-09-13,1,BAL,CLE,Home,381,306,270,168,3,1,111,138,2,0,3,3
2020-09-17,2,CLE,CIN,Home,434,353,219,285,2,3,215,68,3,0,1,1
2020-09-27,3,CLE,WAS,Home,300,309,142,206,2,2,158,103,2,1,0,0
2020-10-04,4,DAL,CLE,Away,566,508,481,201,4,3,85,307,1,3,0,0
2020-10-11,5,CLE,IND,Home,385,308,261,240,2,0,124,68,0,1,2,2
2020-10-18,6,PIT,CLE,Home,277,220,148,145,1,1,129,75,3,0,2,2
2020-10-25,7,CIN,CLE,Away,468,398,387,316,3,5,81,82,1,0,1,1
2020-11-01,8,CLE,LVR,Away,223,309,122,100,0,1,101,209,0,0,1,1
2020-11-15,10,CLE,HOU,Home,356,243,125,153,0,1,231,90,1,0,0,0
2020-11-22,11,CLE,PHI,Home,324,315,187,209,0,2,137,106,1,0,1,1
2020-11-29,12,JAX,CLE,Away,375,459,235,252,2,2,140,207,1,1,1,1
2020-12-06,13,TEN,CLE,Away,431,458,369,340,3,4,62,118,1,1,1,1
2020-12-14,14,CLE,BAL,Away,493,385,355,154,2,1,138,231,4,5,1,1
2020-12-20,15,NYG,CLE,Away,288,392,214,286,0,2,74,106,0,1,0,0
2020-12-27,16,NYJ,CLE,Home,333,299,202,254,3,0,131,45,0,2,2,2
2021-01-03,17,CLE,PIT,Home,358,394,166,309,1,2,192,85,2,0,0,0
2021-09-12,1,KAN,CLE,Home,397,457,324,304,3,0,73,153,1,4,2,2
2021-09-19,2,CLE,HOU,Home,355,302,199,220,1,2,156,82,3,1,2,2
2021-09-26,3,CLE,CHI,Home,418,47,203,1,1,0,215,46,1,0,0,0
2021-10-03,4,MIN,CLE,Away,255,327,190,143,1,0,65,184,0,1,0,0
2021-10-10,5,LAC,CLE,Home,493,531,381,301,4,2,112,230,3,3,0,0
2021-10-17,6,CLE,ARI,Away,290,352,217,208,2,4,73,144,0,0,3,3
2021-10-21,7,CLE,DEN,Home,376,223,194,182,1,2,182,41,1,0,0,0
2021-10-31,8,CLE,PIT,Away,306,370,210,255,0,1,96,115,1,1,1,1
2021-11-07,9,CIN,CLE,Away,348,361,263,208,0,2,85,153,2,2,0,0
2021-11-14,10,NWE,CLE,Home,452,217,268,118,4,1,184,99,2,0,1,1
2021-11-21,11,CLE,DET,Home,349,245,165,77,1,0,184,168,1,1,2,2
2021-11-28,12,BAL,CLE,Home,303,262,155,222,1,1,148,40,0,0,2,2
2021-12-12,14,CLE,BAL,Home,290,389,190,271,2,1,100,118,0,1,1,1
2021-12-20,15,CLE,LVR,Away,236,328,147,230,1,1,89,98,1,0,0,0
2021-12-25,16,GNB,CLE,Home,311,408,202,189,3,2,109,219,0,1,4,4
2022-01-03,17,PIT,CLE,Home,299,232,109,139,1,2,190,93,1,0,2,2
2022-01-09,18,CLE,CIN,Home,376,182,171,103,2,1,205,79,1,0,2,2
2022-09-11,1,CAR,CLE,Away,261,355,207,138,1,1,54,217,2,1,0,0
2022-09-18,2,CLE,NYJ,Away,405,402,221,309,1,4,184,93,3,0,1,1
2022-09-22,3,CLE,PIT,Home,376,308,205,204,2,0,171,104,1,2,0,0
2022-10-02,4,ATL,CLE,Home,333,403,131,226,0,0,202,177,2,2,2,2
2022-10-09,5,CLE,LAC,Away,443,465,230,227,1,1,213,238,3,2,1,1
2022-10-16,6,CLE,NWE,Away,328,399,258,301,1,2,70,98,0,3,4,4
2022-10-23,7,BAL,CLE,Home,254,336,94,223,0,0,160,113,2,2,2,2
2022-10-31,8,CLE,CIN,Home,440,229,268,193,1,2,172,36,3,0,2,2
2022-11-13,10,MIA,CLE,Home,491,297,296,185,3,1,195,112,2,1,1,1
2022-11-20,11,BUF,CLE,Home,357,396,186,316,1,3,171,80,1,0,1,1
2022-11-27,12,CLE,TAM,Home,367,325,178,229,1,2,189,96,2,0,1,1
2022-12-04,13,HOU,CLE,Away,283,304,201,130,1,0,82,174,0,0,2,2
2022-12-11,14,CIN,CLE,Home,363,344,227,273,2,1,136,71,1,0,1,1
2022-12-17,15,CLE,BAL,Home,283,324,140,126,1,0,143,198,0,0,0,0
2022-12-24,16,CLE,NOR,Away,249,244,125,92,0,0,124,152,1,2,1,1
2023-01-01,17,WAS,CLE,Away,260,301,124,155,0,3,136,146,1,0,0,0
2023-01-08,18,PIT,CLE,Home,333,307,189,173,1,2,144,134,2,0,2,2
2023-09-10,1,CLE,CIN,Home,350,142,144,67,1,0,206,75,1,0,2,2
2023-09-18,2,PIT,CLE,Home,255,408,200,210,1,1,55,198,0,1,4,4
2023-09-24,3,CLE,TEN,Home,341,94,263,68,2,0,78,26,1,0,1,1
2023-10-01,4,CLE,BAL,Away,166,296,73,165,0,2,93,131,0,2,3,3
2023-10-15,6,CLE,SFO,Home,334,215,174,107,0,1,160,108,1,1,2,2
2023-10-22,7,IND,CLE,Away,456,316,288,166,2,0,168,150,3,3,2,2
2023-10-29,8,SEA,CLE,Home,362,385,248,230,2,1,114,155,1,1,3,3
2023-11-05,9,CLE,ARI,Home,326,58,213,17,2,0,113,41,1,0,0,0
2023-11-12,10,BAL,CLE,Away,306,373,200,195,1,1,106,178,2,1,2,2
2023-11-19,11,CLE,PIT,Home,259,249,163,77,0,0,96,172,1,1,1,1
2023-11-26,12,DEN,CLE,Home,294,269,125,162,1,1,169,107,2,0,3,3
2023-12-03,13,LAR,CLE,Home,399,327,279,240,3,2,120,87,1,0,1,1
2023-12-10,14,CLE,JAX,Home,389,293,307,235,3,3,82,58,1,1,3,3
2023-12-17,15,CLE,CHI,Home,377,236,348,148,2,1,29,88,0,0,3,3
2023-12-24,16,HOU,CLE,Away,250,418,178,364,2,3,72,54,0,2,2,2
2023-12-28,17,CLE,NYJ,Home,428,360,301,253,3,1,127,107,1,0,3,3
2024-01-07,18,CIN,CLE,Home,328,244,145,140,3,2,183,104,1,0,2,2
2014-09-07,1,DAL,SFO,Away,382,319,255,192,1,2,127,127,1,1,4,4
2014-09-14,2,TEN,DAL,Away,314,368,232,148,1,1,82,220,0,1,1,1
2014-09-21,3,LAR,DAL,Away,448,340,327,217,3,2,121,123,0,1,2,2
2014-09-28,4,DAL,NOR,Home,445,438,255,334,3,2,190,104,2,0,0,0
2014-10-05,5,DAL,HOU,Home,456,330,316,154,2,0,140,176,0,2,3,3
2014-10-12,6,SEA,DAL,Away,206,401,126,239,0,2,80,162,1,1,2,2
2014-10-19,7,DAL,NYG,Home,423,352,267,248,3,3,156,104,1,0,1,1
2014-10-27,8,DAL,WAS,Away,395,409,224,286,2,0,171,123,0,2,2,2
2014-11-02,9,DAL,ARI,Away,266,339,174,237,1,3,92,102,0,1,2,2
2014-11-09,10,JAX,DAL,Away,333,399,262,248,0,3,71,151,2,1,1,1
2014-11-23,12,NYG,DAL,Away,417,385,328,266,3,4,89,119,1,0,1,1
2014-11-27,13,DAL,PHI,Away,267,464,174,208,0,1,93,256,1,2,3,3
2014-12-04,14,CHI,DAL,Away,376,397,341,203,2,3,35,194,2,2,0,0
2014-12-14,15,PHI,DAL,Away,294,364,219,249,0,3,75,115,3,2,1,1
2014-12-21,16,DAL,IND,Home,377,229,250,228,5,1,127,1,1,0,1,1
2014-12-28,17,WAS,DAL,Away,413,473,309,299,1,2,104,174,1,2,1,1
2015-09-13,1,DAL,NYG,Home,436,288,356,189,3,0,80,99,0,1,3,3
2015-09-20,2,PHI,DAL,Away,226,359,219,250,1,1,7,109,0,0,2,2
2015-09-27,3,DAL,ATL,Away,347,438,220,280,0,2,127,158,4,3,1,1
2015-10-04,4,NOR,DAL,Home,438,335,335,220,2,1,103,115,1,1,0,0
2015-10-11,5,DAL,NWE,Away,265,356,163,247,0,2,102,109,0,1,2,2
2015-10-25,7,NYG,DAL,Home,289,460,157,227,0,1,132,233,1,1,4,4
2015-11-01,8,DAL,SEA,Away,220,323,91,210,0,1,129,113,0,0,0,0
2015-11-08,9,DAL,PHI,Away,411,459,277,287,3,1,134,172,0,2,1,1
2015-11-15,10,TAM,DAL,Home,330,216,246,174,0,0,84,42,1,0,1,1
2015-11-22,11,MIA,DAL,Away,210,386,140,220,2,2,70,166,0,0,2,2
2015-11-26,12,DAL,CAR,Away,210,294,179,165,1,0,31,129,0,1,3,3
2015-12-07,13,WAS,DAL,Away,266,318,193,221,1,0,73,97,0,1,3,3
2015-12-13,14,GNB,DAL,Home,435,270,205,99,2,0,230,171,2,1,1,1
2015-12-19,15,DAL,NYJ,Away,309,372,176,299,1,1,133,73,0,1,4,4
2015-12-27,16,BUF,DAL,Home,408,307,172,186,0,0,236,121,2,0,2,2
2016-01-03,17,DAL,WAS,Away,512,437,412,291,3,4,100,146,0,0,4,4
2016-09-11,1,DAL,NYG,Away,328,316,227,203,0,3,101,113,1,0,0,0
2016-09-18,2,WAS,DAL,Away,432,380,350,278,1,0,82,102,1,3,1,1
2016-09-25,3,DAL,CHI,Home,447,390,248,312,1,2,199,78,3,0,1,1
2016-10-02,4,SFO,DAL,Away,295,428,189,234,1,2,106,194,1,1,0,0
2016-10-09,5,DAL,CIN,Home,402,345,222,249,1,2,180,96,3,0,1,1
2016-10-16,6,GNB,DAL,Away,372,424,294,233,1,3,78,191,0,0,2,2
2016-10-30,8,DAL,PHI,Home,460,291,273,194,2,1,187,97,1,1,1,1
2016-11-06,9,CLE,DAL,Away,222,423,177,255,1,3,45,168,0,2,0,0
2016-11-13,10,PIT,DAL,Away,448,422,400,295,3,2,48,127,1,2,1,1
2016-11-20,11,DAL,BAL,Home,417,368,299,267,3,1,118,101,0,1,0,0
2016-11-24,12,DAL,WAS,Home,353,505,190,449,1,3,163,56,3,0,0,0
2016-12-01,13,MIN,DAL,Away,318,264,231,124,1,1,87,140,0,1,2,2
2016-12-11,14,NYG,DAL,Home,260,260,167,152,1,1,93,108,0,0,3,3
2016-12-18,15,DAL,TAM,Home,449,276,264,224,0,2,185,52,2,0,1,1
2016-12-26,16,DAL,DET,Home,375,319,211,229,4,0,164,90,2,3,0,0
2017-01-01,17,PHI,DAL,Home,346,195,232,126,2,1,114,69,1,0,2,2
2017-09-10,1,DAL,NYG,Home,392,233,263,198,1,0,129,35,0,0,0,0
2017-09-17,2,DEN,DAL,Home,380,268,202,228,4,2,178,40,1,0,2,2
2017-09-25,3,ARI,DAL,Away,332,273,283,174,2,2,49,99,0,2,0,0
2017-10-01,4,DAL,LAR,Away,440,412,251,244,3,2,189,168,1,0,2,2
2017-10-08,5,DAL,GNB,Away,408,342,245,182,3,3,163,160,1,1,3,3
2017-10-22,7,SFO,DAL,Away,290,501,187,236,0,3,103,265,1,3,0,0
2017-10-29,8,WAS,DAL,Away,285,307,236,138,1,0,49,169,1,2,1,1
2017-11-05,9,DAL,KAN,Home,375,323,244,255,2,2,131,68,2,0,0,0
2017-11-12,10,ATL,DAL,Home,336,233,204,126,2,0,132,107,1,1,2,2
2017-11-19,11,DAL,PHI,Away,225,383,113,168,0,2,112,215,0,2,4,4
2017-11-23,12,DAL,LAC,Away,247,515,168,434,0,3,79,81,1,0,2,2
2017-11-30,13,DAL,WAS,Home,275,280,93,224,2,2,182,56,2,0,0,0
2017-12-10,14,NYG,DAL,Away,330,454,228,332,1,3,102,122,0,1,0,0
2017-12-17,15,LVR,DAL,Away,293,330,171,204,2,0,122,126,0,2,2,2
2017-12-24,16,DAL,SEA,Away,282,136,154,60,0,2,128,76,0,0,3,3
2017-12-31,17,PHI,DAL,Away,219,301,149,172,0,1,70,129,0,0,1,1
2018-09-09,1,CAR,DAL,Home,293,232,146,138,0,0,147,94,2,1,1,1
2018-09-16,2,DAL,NYG,Home,298,255,160,220,1,1,138,35,1,0,0,0
2018-09-23,3,SEA,DAL,Home,295,303,182,137,2,1,113,166,1,0,3,3
2018-09-30,4,DAL,DET,Home,414,382,231,286,2,2,183,96,0,1,0,0
2018-10-07,5,HOU,DAL,Home,462,292,374,194,1,1,88,98,0,0,2,2
2018-10-14,6,DAL,JAX,Home,378,204,172,139,2,1,206,65,2,0,0,0
2018-10-21,7,WAS,DAL,Home,305,323,175,250,1,1,130,73,0,1,2,2
2018-11-05,9,DAL,TEN,Away,297,340,225,215,2,2,72,125,0,2,2,2
2018-11-11,10,PHI,DAL,Away,421,410,350,239,2,1,71,171,0,2,0,0
2018-11-18,11,ATL,DAL,Away,354,323,274,191,1,0,80,132,0,2,0,0
2018-11-22,12,DAL,WAS,Home,404,331,258,251,2,2,146,80,2,1,0,0
2018-11-29,13,DAL,NOR,Home,308,176,209,111,1,1,99,65,0,0,2,2
2018-12-09,14,DAL,PHI,Home,576,256,434,222,3,3,142,34,0,0,3,3
2018-12-16,15,IND,DAL,Home,370,292,192,180,0,0,178,112,2,0,1,1
2018-12-23,16,DAL,TAM,Home,232,383,152,320,1,1,80,63,1,1,0,0
2018-12-30,17,NYG,DAL,Away,441,419,298,368,2,4,143,51,2,1,1,1
2019-09-08,1,DAL,NYG,Home,494,470,405,319,4,1,89,151,1,1,0,0
2019-09-15,2,WAS,DAL,Away,255,474,208,261,2,3,47,213,1,1,1,1
2019-09-22,3,DAL,MIA,Home,476,283,241,211,2,0,235,72,2,0,1,1
2019-09-29,4,NOR,DAL,Home,266,257,149,212,0,0,117,45,0,1,3,3
2019-10-06,5,DAL,GNB,Away,563,335,441,215,2,0,122,120,1,4,3,3
2019-10-13,6,NYJ,DAL,Home,382,399,326,270,2,0,56,129,1,2,0,0
2019-10-20,7,DAL,PHI,Home,402,283,213,168,1,1,189,115,3,0,1,1
2019-11-04,9,NYG,DAL,Away,271,429,171,257,1,3,100,172,0,0,2,2
2019-11-10,10,DAL,MIN,Away,443,364,393,211,3,2,50,153,0,1,1,1
2019-11-17,11,DET,DAL,Away,312,509,191,434,2,3,121,75,2,1,1,1
2019-11-24,12,NWE,DAL,Home,282,321,181,212,1,0,101,109,0,0,1,1
2019-11-28,13,DAL,BUF,Away,426,356,323,232,2,2,103,124,0,1,2,2
2019-12-05,14,CHI,DAL,Home,382,408,231,326,3,1,151,82,1,2,0,0
2019-12-15,15,DAL,LAR,Home,475,289,212,267,2,2,263,22,3,1,0,0
2019-12-22,16,PHI,DAL,Home,431,311,313,257,1,0,118,54,1,0,1,1
2019-12-29,17,DAL,WAS,Home,517,271,294,183,4,1,223,88,1,0,1,1
2020-09-13,1,LAR,DAL,Home,422,380,269,244,0,1,153,136,2,1,0,0
2020-09-20,2,DAL,ATL,Home,570,380,445,267,1,4,125,113,4,0,3,3
2020-09-27,3,SEA,DAL,Home,412,522,295,461,5,3,117,61,0,1,3,3
2020-10-04,4,DAL,CLE,Away,566,508,481,201,4,3,85,307,1,3,3,3
2020-10-11,5,DAL,NYG,Home,402,300,276,211,1,0,126,89,2,2,2,2
2020-10-19,6,DAL,ARI,Away,344,438,247,177,1,2,97,261,0,3,4,4
2020-10-25,7,WAS,DAL,Home,397,142,189,59,2,0,208,83,1,0,1,1
2020-11-01,8,PHI,DAL,Home,222,265,103,132,2,0,119,133,0,0,2,2
2020-11-08,9,DAL,PIT,Away,364,355,220,309,1,3,144,46,0,0,2,2
2020-11-22,11,MIN,DAL,Away,430,376,305,196,3,3,125,180,1,1,1,1
2020-11-26,12,DAL,WAS,Away,247,338,187,156,1,1,60,182,0,3,2,2
2020-12-08,13,BAL,DAL,Home,401,388,107,277,2,2,294,111,2,0,1,1
2020-12-13,14,CIN,DAL,Away,309,272,208,171,1,2,101,101,0,0,0,0
2020-12-20,15,DAL,SFO,Home,291,458,204,308,2,3,87,150,2,1,0,0
2020-12-27,16,DAL,PHI,Home,513,477,362,326,3,1,151,151,1,1,1,1
2021-01-03,17,NYG,DAL,Home,336,307,211,199,2,0,125,108,1,1,1,1
2021-09-09,1,TAM,DAL,Home,431,451,379,391,4,3,52,60,0,0,1,1
2021-09-19,2,LAC,DAL,Away,408,419,313,221,1,0,95,198,0,2,1,1
2021-09-27,3,DAL,PHI,Home,380,367,220,303,3,2,160,64,2,0,1,1
2021-10-03,4,DAL,CAR,Home,433,379,188,266,4,2,245,113,1,2,0,0
2021-10-10,5,DAL,NYG,Home,515,367,314,294,3,1,201,73,1,1,2,2
2021-10-17,6,NWE,DAL,Away,335,567,215,445,2,3,120,122,2,0,2,2
2021-10-31,8,MIN,DAL,Away,278,419,177,341,1,2,101,78,0,0,2,2
2021-11-07,9,DAL,DEN,Away,290,407,212,217,2,1,78,190,0,2,2,2
2021-11-14,10,DAL,ATL,Home,431,214,317,111,2,0,114,103,3,0,1,1
2021-11-21,11,KAN,DAL,Home,370,276,244,194,0,0,126,82,2,0,3,3
2021-11-25,12,DAL,LVR,Away,437,509,373,366,2,1,64,143,1,2,0,0
2021-12-02,13,NOR,DAL,Away,405,377,252,231,2,1,153,146,0,1,1,1
2021-12-12,14,WAS,DAL,Away,224,323,124,201,1,1,100,122,1,0,2,2
2021-12-19,15,NYG,DAL,Away,302,328,178,203,0,1,124,125,0,1,1,1
2021-12-26,16,DAL,WAS,Home,497,257,389,172,5,2,108,85,1,0,0,0
2022-01-02,17,DAL,ARI,Away,301,399,256,272,3,2,45,127,0,0,1,1
2022-01-08,18,PHI,DAL,Away,315,475,166,304,2,5,149,171,1,2,0,0
2022-09-11,1,DAL,TAM,Away,244,347,173,195,0,1,71,152,0,0,1,1
2022-09-18,2,DAL,CIN,Home,337,254,230,165,1,1,107,89,1,0,1,1
2022-09-26,3,NYG,DAL,Away,336,391,169,215,0,1,167,176,1,1,0,0
2022-10-02,4,DAL,WAS,Home,279,297,217,155,2,1,62,142,0,0,0,0
2022-10-09,5,LAR,DAL,Away,323,239,285,76,1,0,38,163,0,1,0,0
2022-10-16,6,PHI,DAL,Home,268,315,132,181,2,1,136,134,1,1,3,3
2022-10-23,7,DAL,DET,Home,330,312,191,195,1,0,139,117,2,0,1,1
2022-10-30,8,DAL,CHI,Home,442,371,242,131,2,2,200,240,4,2,1,1
2022-11-13,10,GNB,DAL,Home,415,421,208,262,3,3,207,159,1,1,2,2
2022-11-20,11,MIN,DAL,Away,183,458,110,307,0,2,73,151,0,2,0,0
2022-11-24,12,DAL,NYG,Home,430,300,261,210,2,1,169,90,2,1,2,2
2022-12-04,13,DAL,IND,Home,385,309,165,203,3,2,220,106,4,0,1,1
2022-12-11,14,DAL,HOU,Home,404,327,277,213,1,1,127,114,2,1,3,3
2022-12-18,15,JAX,DAL,Home,503,397,311,243,4,3,192,154,0,1,2,2
2022-12-24,16,DAL,PHI,Home,419,442,304,355,3,2,115,87,1,1,1,1
2022-12-29,17,TEN,DAL,Away,317,361,220,274,1,2,97,87,0,1,3,3
2023-01-08,18,WAS,DAL,Home,309,182,158,118,1,1,151,64,1,0,2,2
2023-09-10,1,NYG,DAL,Away,171,265,63,143,0,0,108,122,0,3,0,0
2023-09-17,2,DAL,NYJ,Home,382,215,248,151,2,1,134,64,0,0,0,0
2023-09-24,3,ARI,DAL,Home,400,416,178,231,1,1,222,185,2,0,1,1
2023-10-01,4,DAL,NWE,Home,377,253,253,200,1,0,124,53,1,0,0,0
2023-10-08,5,SFO,DAL,Home,421,197,251,140,4,1,170,57,2,0,4,4
2023-10-16,6,LAC,DAL,Away,272,342,219,246,2,1,53,96,0,1,1,1
2023-10-29,8,DAL,LAR,Home,387,280,285,188,4,1,102,92,0,1,1,1
2023-11-05,9,PHI,DAL,Home,292,406,183,333,2,3,109,73,2,0,1,1
2023-11-12,10,DAL,NYG,Home,640,172,472,61,4,2,168,111,3,0,2,2
2023-11-19,11,CAR,DAL,Away,187,311,77,204,1,2,110,107,0,1,0,0
2023-11-23,12,DAL,WAS,Home,431,376,331,268,4,0,100,108,1,1,0,0
2023-11-30,13,DAL,SEA,Home,411,406,275,334,3,3,136,72,1,2,0,0
2023-12-10,14,DAL,PHI,Home,394,324,256,218,2,0,138,106,1,0,1,1
2023-12-17,15,BUF,DAL,Home,351,195,85,106,1,0,266,89,3,1,1,1
2023-12-24,16,MIA,DAL,Home,375,339,284,242,1,2,91,97,0,0,1,1
2023-12-30,17,DAL,DET,Home,384,420,323,295,2,1,61,125,0,1,2,2
2024-01-07,18,WAS,DAL,Away,180,440,130,309,1,4,50,131,0,1,1,1
2014-09-07,1,DEN,IND,Home,361,408,259,354,3,2,102,54,1,1,0,0
2014-09-14,2,DEN,KAN,Home,325,380,237,247,3,0,88,133,0,2,0,0
2014-09-21,3,SEA,DEN,Home,384,332,255,296,2,2,129,36,1,0,2,2
2014-10-05,5,DEN,ARI,Home,568,215,476,178,4,1,92,37,1,1,2,2
2014-10-12,6,NYJ,DEN,Away,204,359,173,221,2,3,31,138,0,0,0,0
2014-10-19,7,DEN,SFO,Home,419,310,304,248,4,2,115,62,2,0,0,0
2014-10-23,8,DEN,LAC,Home,425,306,286,245,3,3,139,61,2,0,0,0
2014-11-02,9,NWE,DEN,Home,398,472,332,429,4,2,66,43,0,1,2,2
2014-11-09,10,LVR,DEN,Away,222,471,192,353,2,5,30,118,0,0,2,2
2014-11-16,11,LAR,DEN,Home,337,397,206,369,1,1,131,28,0,0,2,2
2014-11-23,12,DEN,MIA,Home,450,313,249,216,4,3,201,97,1,2,1,1
2014-11-30,13,KAN,DEN,Away,151,388,110,174,2,2,41,214,0,0,1,1
2014-12-07,14,DEN,BUF,Home,306,415,173,341,0,1,133,74,3,1,3,3
2014-12-14,15,LAC,DEN,Away,288,337,232,226,1,1,56,111,0,0,0,0
2014-12-22,16,CIN,DEN,Home,353,385,146,300,2,2,207,85,1,1,4,4
2014-12-28,17,DEN,LVR,Home,451,199,309,132,1,1,142,67,3,0,1,1
2015-09-13,1,DEN,BAL,Home,219,173,150,100,0,0,69,73,0,0,1,1
2015-09-17,2,KAN,DEN,Away,314,299,167,238,0,3,147,61,2,0,1,1
2015-09-27,3,DET,DEN,Away,290,354,262,313,1,2,28,41,1,1,2,2
2015-10-04,4,DEN,MIN,Home,344,325,200,212,1,1,144,113,1,1,2,2
2015-10-11,5,LVR,DEN,Away,288,297,223,254,1,0,65,43,0,0,2,2
2015-10-18,6,CLE,DEN,Away,298,442,189,290,2,1,109,152,0,0,3,3
2015-11-01,8,DEN,GNB,Home,500,140,340,50,0,0,160,90,3,1,1,1
2015-11-08,9,IND,DEN,Home,365,309,245,274,2,2,120,35,1,0,2,2
2015-11-15,10,DEN,KAN,Away,221,303,152,197,1,1,69,106,1,1,5,5
2015-11-22,11,CHI,DEN,Away,347,389,261,219,0,2,86,170,1,0,0,0
2015-11-29,12,DEN,NWE,Home,433,301,254,262,1,3,179,39,3,0,1,1
2015-12-06,13,LAC,DEN,Away,272,293,179,159,0,1,93,134,0,0,1,1
2015-12-13,14,DEN,LVR,Away,310,126,276,99,0,2,34,27,0,0,2,2
2015-12-20,15,PIT,DEN,Home,377,385,354,281,3,3,23,104,1,1,2,2
2015-12-28,16,DEN,CIN,Home,390,294,277,186,1,1,113,108,1,1,1,1
2016-01-03,17,DEN,LAC,Home,503,317,293,207,1,2,210,110,2,0,5,5
2016-09-08,1,DEN,CAR,Home,307,333,159,176,1,1,148,157,2,1,3,3
2016-09-18,2,DEN,IND,Home,400,253,266,170,0,1,134,83,1,1,1,1
2016-09-25,3,CIN,DEN,Away,332,355,189,303,0,4,143,52,2,0,1,1
2016-10-02,4,TAM,DEN,Away,215,307,143,218,0,2,72,89,1,1,0,0
2016-10-09,5,DEN,ATL,Away,267,372,183,250,1,1,84,122,0,1,1,1
2016-10-13,6,LAC,DEN,Home,265,304,166,220,1,1,99,84,0,0,2,2
2016-10-24,7,DEN,HOU,Home,347,271,157,131,1,0,190,140,2,0,0,0
2016-10-30,8,DEN,LAC,Home,324,369,267,246,0,2,57,123,2,0,3,3
2016-11-06,9,LVR,DEN,Home,397,299,179,266,0,2,218,33,3,0,2,2
2016-11-13,10,NOR,DEN,Away,373,337,293,234,3,2,80,103,0,0,2,2
2016-11-27,12,DEN,KAN,Away,464,273,340,190,3,1,124,83,0,1,1,1
2016-12-04,13,JAX,DEN,Away,333,206,179,102,0,0,154,104,1,1,0,0
2016-12-11,14,TEN,DEN,Home,253,348,73,330,0,1,180,18,1,0,2,2
2016-12-18,15,DEN,NWE,Away,309,313,251,177,0,0,58,136,0,1,3,3
2016-12-25,16,KAN,DEN,Home,484,246,246,183,2,0,238,63,2,1,3,3
2017-01-01,17,DEN,LVR,Home,349,221,206,164,2,1,143,57,1,0,1,1
2017-09-11,1,DEN,LAC,Home,321,249,181,185,2,3,140,64,1,0,2,2
2017-09-17,2,DEN,DAL,Home,380,268,202,228,4,2,178,40,1,0,2,2
2017-09-24,3,BUF,DEN,Home,272,366,197,255,2,0,75,111,0,1,2,2
2017-10-01,4,DEN,LVR,Home,298,254,155,230,1,1,143,24,0,0,0,0
2017-10-15,6,DEN,NYG,Away,412,266,366,118,1,1,46,148,0,0,3,3
2017-10-22,7,LAC,DEN,Home,242,251,162,182,2,0,80,69,0,0,3,3
2017-10-30,8,KAN,DEN,Home,276,364,197,187,1,1,79,177,0,1,5,5
2017-11-05,9,PHI,DEN,Home,419,226,222,191,4,1,197,35,3,0,2,2
2017-11-12,10,DEN,NWE,Away,339,396,221,297,1,3,118,99,0,1,2,2
2017-11-19,11,DEN,CIN,Away,341,190,229,141,1,3,112,49,1,0,2,2
2017-11-26,12,LVR,DEN,Home,348,216,244,160,2,2,104,56,1,0,1,1
2017-12-03,13,MIA,DEN,Home,367,270,222,167,2,0,145,103,1,0,3,3
2017-12-10,14,DEN,NYJ,Home,273,100,189,41,1,0,84,59,1,0,0,0
2017-12-14,15,IND,DEN,Away,228,462,158,251,0,2,70,211,1,1,1,1
2017-12-24,16,WAS,DEN,Home,386,330,299,171,3,0,87,159,0,1,3,3
2017-12-31,17,DEN,KAN,Away,336,379,226,269,2,0,110,110,0,2,3,3
2018-09-09,1,DEN,SEA,Home,470,306,324,242,3,3,146,64,0,0,3,3
2018-09-16,2,DEN,LVR,Home,385,373,217,281,0,1,168,92,2,1,1,1
2018-09-23,3,BAL,DEN,Home,342,293,265,173,1,0,77,120,2,2,1,1
2018-10-01,4,DEN,KAN,Away,385,446,226,304,0,1,159,142,2,2,1,1
2018-10-07,5,NYJ,DEN,Home,512,436,189,344,3,2,323,92,1,0,1,1
2018-10-14,6,DEN,LAR,Away,357,444,297,174,2,0,60,270,0,2,1,1
2018-10-18,7,ARI,DEN,Away,223,309,154,178,1,2,69,131,0,2,1,1
2018-10-28,8,KAN,DEN,Home,340,411,291,222,4,2,49,189,0,1,2,2
2018-11-04,9,DEN,HOU,Away,348,290,273,192,1,2,75,98,1,0,1,1
2018-11-18,11,LAC,DEN,Away,479,325,384,217,2,0,95,108,0,3,0,0
2018-11-25,12,DEN,PIT,Home,308,527,184,452,2,2,124,75,1,0,0,0
2018-12-02,13,CIN,DEN,Away,313,361,202,143,1,1,111,218,0,2,1,1
2018-12-09,14,SFO,DEN,Home,389,274,305,171,2,1,84,103,0,1,0,0
2018-12-15,15,DEN,CLE,Away,270,309,238,175,0,2,32,134,1,0,2,2
2018-12-24,16,LVR,DEN,Home,273,300,159,200,0,2,114,100,2,0,2,2
2018-12-30,17,DEN,LAC,Away,370,276,288,160,1,1,82,116,0,1,4,4
2019-09-09,1,LVR,DEN,Home,357,344,259,249,1,1,98,95,2,0,0,0
2019-09-15,2,DEN,CHI,Away,372,273,282,120,1,0,90,153,0,1,1,1
2019-09-22,3,GNB,DEN,Home,312,310,235,161,1,0,77,149,2,2,3,3
2019-09-29,4,DEN,JAX,Away,371,455,303,186,3,2,68,269,0,0,1,1
2019-10-06,5,LAC,DEN,Away,246,350,211,159,0,1,35,191,0,1,2,2
2019-10-13,6,DEN,TEN,Home,270,204,167,165,0,0,103,39,1,0,1,1
2019-10-17,7,DEN,KAN,Away,205,271,134,191,0,2,71,80,1,0,1,1
2019-10-27,8,IND,DEN,Home,318,279,191,166,0,0,127,113,1,1,0,0
2019-11-03,9,DEN,CLE,Home,302,351,175,261,2,1,127,90,1,0,1,1
2019-11-17,11,MIN,DEN,Home,321,394,284,270,3,1,37,124,1,1,1,1
2019-11-24,12,BUF,DEN,Home,424,134,180,49,2,0,244,85,0,0,1,1
2019-12-01,13,DEN,LAC,Home,218,359,134,244,2,2,84,115,0,0,1,1
2019-12-08,14,HOU,DEN,Away,414,391,280,301,1,3,134,90,2,1,1,1
2019-12-15,15,KAN,DEN,Home,419,251,327,199,2,0,92,52,0,0,1,1
2019-12-22,16,DEN,DET,Home,348,191,198,95,1,1,150,96,2,0,0,0
2019-12-29,17,DEN,LVR,Home,238,477,168,380,1,1,70,97,0,0,1,1
2020-09-14,1,DEN,TEN,Away,323,377,216,247,1,2,107,130,1,0,1,1
2020-09-20,2,PIT,DEN,Home,410,319,301,215,2,2,109,104,1,0,2,2
2020-09-27,3,DEN,TAM,Away,226,353,184,285,1,3,42,68,0,0,2,2
2020-10-01,4,NYJ,DEN,Away,321,359,192,242,0,2,129,117,1,2,3,3
2020-10-18,6,NWE,DEN,Away,288,299,171,164,0,0,117,135,1,0,2,2
2020-10-25,7,DEN,KAN,Away,411,286,234,185,0,1,177,101,2,2,4,4
2020-11-01,8,DEN,LAC,Home,351,485,243,275,3,3,108,210,1,0,1,1
2020-11-08,9,ATL,DEN,Home,363,405,271,302,3,2,92,103,1,1,1,1
2020-11-15,10,LVR,DEN,Home,357,313,154,247,0,1,203,66,4,0,5,5
2020-11-22,11,DEN,MIA,Home,459,223,270,167,0,1,189,56,2,0,2,2
2020-11-29,12,DEN,NOR,Away,112,292,12,63,0,0,100,229,0,4,3,3
2020-12-06,13,KAN,DEN,Home,447,330,313,151,1,2,134,179,0,0,2,2
2020-12-13,14,CAR,DEN,Away,370,365,245,269,0,4,125,96,3,0,1,1
2020-12-19,15,DEN,BUF,Away,255,534,115,352,1,2,140,182,2,3,1,1
2020-12-27,16,LAC,DEN,Home,316,396,227,263,1,0,89,133,0,1,2,2
2021-01-03,17,DEN,LVR,Away,446,465,324,359,2,2,122,106,1,2,0,0
2021-09-12,1,NYG,DEN,Away,314,420,254,255,1,2,60,165,1,1,1,1
2021-09-19,2,JAX,DEN,Away,189,398,114,302,1,2,75,96,0,0,0,0
2021-09-26,3,DEN,NYJ,Home,343,162,223,119,0,0,120,43,2,0,1,1
2021-10-03,4,DEN,BAL,Away,254,406,148,304,1,1,106,102,0,1,1,1
2021-10-10,5,PIT,DEN,Home,391,374,244,268,2,2,147,106,1,0,1,1
2021-10-17,6,DEN,LVR,Away,421,426,309,340,3,2,112,86,0,2,4,4
2021-10-21,7,CLE,DEN,Home,376,223,194,182,1,2,182,41,1,0,1,1
2021-10-31,8,DEN,WAS,Home,273,342,190,230,1,1,83,112,1,0,1,1
2021-11-07,9,DAL,DEN,Away,290,407,212,217,2,1,78,190,0,2,0,0
2021-11-14,10,DEN,PHI,Away,308,386,212,170,0,2,96,216,1,0,1,1
2021-11-28,12,DEN,LAC,Home,302,357,155,285,1,2,147,72,2,0,1,1
2021-12-05,13,KAN,DEN,Home,267,404,178,250,0,1,89,154,1,0,3,3
2021-12-12,14,DEN,DET,Home,358,316,174,198,2,1,184,118,3,0,0,0
2021-12-19,15,DEN,CIN,Away,292,249,159,136,1,1,133,113,0,0,1,1
2021-12-26,16,LVR,DEN,Home,342,158,182,140,1,0,160,18,1,1,0,0
2022-01-02,17,LAC,DEN,Home,341,319,237,236,2,1,104,83,1,0,1,1
2022-01-08,18,DEN,KAN,Away,364,390,173,255,0,2,191,135,3,0,1,1
2022-09-12,1,SEA,DEN,Home,253,433,177,330,2,1,76,103,0,0,2,2
2022-09-18,2,DEN,HOU,Home,350,234,201,154,1,0,149,80,0,0,1,1
2022-09-25,3,DEN,SFO,Home,261,267,160,179,0,1,101,88,1,0,0,0
2022-10-02,4,LVR,DEN,Home,385,299,173,214,0,2,212,85,2,1,1,1
2022-10-06,5,DEN,IND,Away,375,306,250,200,0,0,125,106,0,0,2,2
2022-10-17,6,LAC,DEN,Home,297,258,224,160,0,1,73,98,1,0,1,1
2022-10-23,7,DEN,NYJ,Away,324,260,219,105,0,0,105,155,1,1,1,1
2022-10-30,8,JAX,DEN,Away,305,331,114,230,1,1,191,101,1,2,1,1
2022-11-13,10,TEN,DEN,Home,307,313,244,248,2,1,63,65,0,0,1,1
2022-11-20,11,DEN,LVR,Away,320,407,226,298,0,2,94,109,1,0,0,0
2022-11-27,12,CAR,DEN,Home,349,246,164,125,1,1,185,121,1,0,2,2
2022-12-04,13,BAL,DEN,Home,285,272,182,184,0,0,103,88,1,0,0,0
2022-12-11,14,DEN,KAN,Away,320,431,214,342,4,3,106,89,0,0,2,2
2022-12-18,15,DEN,ARI,Home,324,240,156,167,1,0,168,73,2,1,2,2
2022-12-25,16,LAR,DEN,Home,388,323,230,219,2,1,158,104,3,0,4,4
2023-01-01,17,KAN,DEN,Home,374,307,328,190,3,1,46,117,1,2,2,2
2023-01-08,18,DEN,LAC,Home,471,352,266,293,3,3,205,59,1,0,2,2
2023-09-10,1,DEN,LVR,Away,260,261,166,200,2,2,94,61,0,0,0,0
2023-09-17,2,DEN,WAS,Away,399,388,277,266,3,2,122,122,1,2,2,2
2023-09-24,3,MIA,DEN,Home,726,363,376,294,5,1,350,69,5,0,3,3
2023-10-01,4,CHI,DEN,Away,471,311,300,214,4,3,171,97,0,0,0,0
2023-10-08,5,DEN,NYJ,Away,308,407,169,173,2,0,139,234,0,1,3,3
2023-10-12,6,KAN,DEN,Home,389,197,293,82,1,1,96,115,0,0,3,3
2023-10-22,7,DEN,GNB,Home,339,331,194,194,1,2,145,137,0,0,0,0
2023-10-29,8,DEN,KAN,Home,240,274,87,212,3,0,153,62,0,0,1,1
2023-11-13,10,BUF,DEN,Away,369,300,177,178,1,2,192,122,2,0,1,1
2023-11-19,11,DEN,MIN,Home,295,385,249,210,1,1,46,175,0,1,0,0
2023-11-26,12,DEN,CLE,Home,294,269,125,162,1,1,169,107,2,0,1,1
2023-12-03,13,HOU,DEN,Home,353,282,264,164,1,1,89,118,1,1,3,3
2023-12-10,14,LAC,DEN,Away,283,322,207,216,0,2,76,106,1,1,1,1
2023-12-16,15,DET,DEN,Home,448,287,263,204,5,1,185,83,1,1,1,1
2023-12-24,16,DEN,NWE,Away,276,289,193,230,2,2,83,59,1,0,2,2
2023-12-31,17,DEN,LAC,Home,313,301,212,215,1,0,101,86,0,0,0,0
2024-01-07,18,LVR,DEN,Home,359,286,230,238,2,1,129,48,1,1,1,1
2014-09-08,1,DET,NYG,Home,417,197,341,144,2,1,76,53,2,1,0,0
2014-09-14,2,CAR,DET,Home,313,323,251,253,1,1,62,70,1,0,3,3
2014-09-21,3,DET,GNB,Home,353,223,238,147,0,1,115,76,1,0,3,3
2014-09-28,4,NYJ,DET,Away,336,360,204,272,1,2,132,88,1,1,0,0
2014-10-05,5,DET,BUF,Away,273,343,204,294,1,1,69,49,0,0,2,2
2014-10-12,6,MIN,DET,Away,212,255,143,155,0,1,69,100,0,1,0,0
2014-10-19,7,DET,NOR,Home,344,408,285,335,2,2,59,73,1,0,2,2
2014-10-26,8,ATL,DET,Away,291,385,213,325,2,2,78,60,1,0,1,1
2014-11-09,10,DET,MIA,Home,351,228,288,178,2,1,63,50,0,0,1,1
2014-11-16,11,ARI,DET,Home,352,262,306,164,2,0,46,98,0,0,1,1
2014-11-23,12,NWE,DET,Home,439,335,349,244,2,0,90,91,2,0,1,1
2014-11-27,13,DET,CHI,Home,474,269,383,256,2,2,91,13,2,0,1,1
2014-12-07,14,DET,TAM,Home,407,233,294,207,3,2,113,26,1,0,1,1
2014-12-14,15,DET,MIN,Home,233,360,153,284,1,1,80,76,0,1,0,0
2014-12-21,16,CHI,DET,Away,234,367,170,229,2,0,64,138,0,2,3,3
2014-12-28,17,GNB,DET,Home,377,313,225,202,2,3,152,111,1,0,1,1
2015-09-13,1,LAC,DET,Home,483,302,387,233,2,2,96,69,2,1,2,2
2015-09-20,2,MIN,DET,Home,350,323,151,285,1,2,199,38,2,0,3,3
2015-09-27,3,DET,DEN,Away,290,354,262,313,1,2,28,41,1,1,3,3
2015-10-05,4,SEA,DET,Home,345,256,235,203,1,0,110,53,0,0,1,1
2015-10-11,5,DET,ARI,Away,435,345,379,158,2,3,56,187,0,3,6,6
2015-10-18,6,DET,CHI,Home,546,444,391,353,4,1,155,91,0,2,3,3
2015-10-25,7,DET,MIN,Away,274,425,197,285,2,2,77,140,0,0,0,0
2015-11-01,8,KAN,DET,Home,340,276,134,195,2,1,206,81,4,0,2,2
2015-11-15,10,GNB,DET,Away,372,287,325,242,2,2,47,45,0,0,1,1
2015-11-22,11,DET,LVR,Home,375,216,266,164,0,0,109,52,1,1,0,0
2015-11-26,12,DET,PHI,Home,430,227,322,159,5,2,108,68,1,0,0,0
2015-12-03,13,DET,GNB,Away,306,313,205,246,2,2,101,67,0,1,1,1
2015-12-13,14,LAR,DET,Home,317,331,114,220,0,2,203,111,2,0,1,1
2015-12-21,15,NOR,DET,Away,399,396,330,246,3,3,69,150,0,2,1,1
2015-12-27,16,DET,SFO,Home,371,322,284,201,2,2,87,121,1,0,0,0
2016-01-03,17,CHI,DET,Away,342,349,231,282,2,3,111,67,0,0,0,0
2016-09-11,1,IND,DET,Away,450,448,368,332,4,3,82,116,0,2,0,0
2016-09-18,2,DET,TEN,Away,375,363,238,224,1,2,137,139,0,0,1,1
2016-09-25,3,GNB,DET,Home,324,418,201,368,4,3,123,50,0,0,1,1
2016-10-02,4,CHI,DET,Home,408,263,294,197,2,0,114,66,0,0,2,2
2016-10-09,5,DET,PHI,Home,244,346,164,230,3,2,80,116,0,0,1,1
2016-10-16,6,DET,LAR,Home,348,387,265,311,4,3,83,76,0,1,0,0
2016-10-23,7,DET,WAS,Home,344,413,250,283,1,1,94,130,1,1,0,0
2016-10-30,8,HOU,DET,Home,269,289,164,231,1,1,105,58,1,0,0,0
2016-11-06,9,MIN,DET,Away,337,311,259,214,1,2,78,97,1,0,1,1
2016-11-20,11,DET,JAX,Home,277,285,263,202,0,2,14,83,1,0,2,2
2016-11-24,12,DET,MIN,Home,308,306,214,224,1,0,94,82,0,1,0,0
2016-12-04,13,NOR,DET,Away,369,422,319,337,0,2,50,85,1,0,0,0
2016-12-11,14,DET,CHI,Home,323,296,209,204,1,1,114,92,1,0,2,2
2016-12-18,15,NYG,DET,Home,300,324,186,268,2,0,114,56,0,0,2,2
2016-12-26,16,DAL,DET,Home,375,319,211,229,4,0,164,90,2,3,2,2
2017-01-01,17,DET,GNB,Away,408,448,332,295,2,4,76,153,1,0,1,1
2017-09-10,1,DET,ARI,Home,367,308,285,263,4,1,82,45,0,1,1,1
2017-09-18,2,NYG,DET,Away,270,257,208,119,1,2,62,138,0,0,1,1
2017-09-24,3,DET,ATL,Away,324,428,253,277,1,2,71,151,0,1,0,0
2017-10-01,4,MIN,DET,Away,284,251,197,154,0,0,87,97,1,1,0,0
2017-10-08,5,DET,CAR,Away,242,362,192,334,2,3,50,28,1,0,1,1
2017-10-15,6,NOR,DET,Home,379,347,186,281,2,3,193,66,2,0,5,5
2017-10-29,8,DET,PIT,Away,482,392,411,317,0,1,71,75,0,1,1,1
2017-11-06,9,GNB,DET,Away,311,417,233,353,0,2,78,64,2,1,1,1
2017-11-12,10,DET,CLE,Home,345,413,241,212,3,1,104,201,1,2,1,1
2017-11-19,11,CHI,DET,Away,398,352,176,287,1,2,222,65,2,0,1,1
2017-11-23,12,DET,MIN,Away,289,408,236,272,2,2,53,136,0,2,2,2
2017-12-03,13,BAL,DET,Home,370,372,269,294,2,1,101,78,2,2,3,3
2017-12-10,14,TAM,DET,Away,400,434,267,381,2,1,133,53,1,2,3,3
2017-12-16,15,DET,CHI,Home,293,349,202,306,2,1,91,43,0,0,1,1
2017-12-24,16,CIN,DET,Home,364,276,222,189,1,1,142,87,1,1,1,1
2017-12-31,17,DET,GNB,Home,356,256,305,153,3,1,51,103,1,0,0,0
2018-09-10,1,DET,NYJ,Away,339,349,300,180,1,2,39,169,0,2,5,5
2018-09-16,2,SFO,DET,Home,346,427,156,329,2,3,190,98,1,0,1,1
2018-09-23,3,DET,NWE,Home,414,209,255,120,2,1,159,89,0,0,1,1
2018-09-30,4,DAL,DET,Home,414,382,231,286,2,2,183,96,0,1,0,0
2018-10-07,5,DET,GNB,Home,264,521,170,423,2,3,94,98,2,0,0,0
2018-10-21,7,MIA,DET,Away,322,457,215,209,2,2,107,248,1,1,0,0
2018-10-28,8,DET,SEA,Away,331,413,297,237,2,3,34,176,0,1,3,3
2018-11-04,9,MIN,DET,Home,283,209,155,143,1,0,128,66,1,0,1,1
2018-11-11,10,CHI,DET,Home,402,305,348,229,3,2,54,76,2,1,3,3
2018-11-18,11,DET,CAR,Home,309,387,215,331,1,3,94,56,1,0,0,0
2018-11-22,12,DET,CHI,Away,333,264,222,226,0,2,111,38,2,0,2,2
2018-12-02,13,DET,LAR,Away,310,344,208,195,1,1,102,149,0,2,2,2
2018-12-09,14,ARI,DET,Away,279,218,218,96,0,0,61,122,0,1,1,1
2018-12-16,15,BUF,DET,Home,312,313,195,208,1,1,117,105,1,1,0,0
2018-12-23,16,DET,MIN,Away,223,340,137,240,0,3,86,100,0,0,0,0
2018-12-30,17,GNB,DET,Away,175,402,129,272,0,3,46,130,0,1,0,0
2019-09-08,1,ARI,DET,Home,387,477,275,361,2,3,112,116,0,0,2,2
2019-09-15,2,DET,LAC,Home,339,424,245,287,2,0,94,137,0,1,2,2
2019-09-22,3,PHI,DET,Away,373,287,246,201,2,1,127,86,1,1,0,0
2019-09-29,4,DET,KAN,Away,447,438,261,315,3,0,186,123,0,3,2,2
2019-10-14,6,GNB,DET,Home,447,299,277,243,2,0,170,56,0,1,0,0
2019-10-20,7,DET,MIN,Away,433,504,352,338,4,4,81,166,0,2,1,1
2019-10-27,8,DET,NYG,Home,375,370,316,290,3,4,59,80,0,0,2,2
2019-11-03,9,LVR,DET,Home,450,473,279,383,2,3,171,90,2,0,2,2
2019-11-10,10,CHI,DET,Home,226,357,145,259,3,1,81,98,0,0,1,1
2019-11-17,11,DET,DAL,Away,312,509,191,434,2,3,121,75,2,1,0,0
2019-11-24,12,WAS,DET,Home,230,364,144,189,0,1,86,175,0,0,4,4
2019-11-28,13,DET,CHI,Away,364,419,259,331,2,3,105,88,0,0,1,1
2019-12-08,14,MIN,DET,Home,354,231,234,161,1,1,120,70,1,0,2,2
2019-12-15,15,DET,TAM,Away,295,495,250,446,0,4,45,49,2,0,3,3
2019-12-22,16,DEN,DET,Home,348,191,198,95,1,1,150,96,2,0,0,0
2019-12-29,17,DET,GNB,Away,305,432,134,312,1,2,171,120,1,0,1,1
2020-09-13,1,DET,CHI,Away,426,363,288,214,1,3,138,149,1,0,1,1
2020-09-20,2,GNB,DET,Home,488,307,229,218,2,2,259,89,2,1,1,1
2020-09-27,3,ARI,DET,Away,377,322,268,232,2,2,109,90,1,0,0,0
2020-10-04,4,DET,NOR,Away,281,392,191,228,3,2,90,164,1,3,1,1
2020-10-18,6,JAX,DET,Away,275,403,231,223,1,1,44,180,1,3,1,1
2020-10-25,7,ATL,DET,Away,388,386,322,322,1,1,66,64,2,1,0,0
2020-11-01,8,DET,IND,Away,326,366,297,247,3,3,29,119,0,2,2,2
2020-11-08,9,MIN,DET,Home,487,421,212,292,3,2,275,129,2,0,3,3
2020-11-15,10,DET,WAS,Home,372,464,267,375,3,0,105,89,0,3,0,0
2020-11-22,11,CAR,DET,Home,374,185,258,145,1,0,116,40,1,0,1,1
2020-11-26,12,DET,HOU,Away,388,384,279,307,1,4,109,77,2,0,3,3
2020-12-06,13,CHI,DET,Away,389,460,249,400,1,3,140,60,3,2,1,1
2020-12-13,14,DET,GNB,Away,293,410,242,290,1,3,51,120,2,1,0,0
2020-12-20,15,TEN,DET,Home,463,430,268,307,3,1,195,123,3,2,3,3
2020-12-26,16,DET,TAM,Away,186,588,113,477,0,6,73,111,0,1,2,2
2021-01-03,17,DET,MIN,Away,417,508,288,383,3,3,129,125,2,2,2,2
2021-09-12,1,DET,SFO,Away,430,442,314,311,3,2,116,131,1,2,1,1
2021-09-20,2,GNB,DET,Home,323,344,227,236,4,2,96,108,1,0,2,2
2021-09-26,3,DET,BAL,Away,285,387,192,271,0,1,93,116,2,0,0,0
2021-10-03,4,CHI,DET,Home,373,351,185,261,0,2,188,90,3,0,2,2
2021-10-10,5,MIN,DET,Home,384,288,264,180,1,0,120,108,0,1,2,2
2021-10-17,6,DET,CIN,Away,228,398,192,256,0,4,36,142,1,0,1,1
2021-10-24,7,LAR,DET,Home,374,415,327,278,3,1,47,137,0,0,2,2
2021-10-31,8,DET,PHI,Away,228,350,171,114,0,0,57,236,1,4,1,1
2021-11-14,10,PIT,DET,Home,387,306,242,77,1,0,145,229,0,2,0,0
2021-11-21,11,CLE,DET,Home,349,245,165,77,1,0,184,168,1,1,2,2
2021-11-25,12,DET,CHI,Away,239,378,163,310,2,1,76,68,0,0,1,1
2021-12-05,13,DET,MIN,Home,372,426,272,326,3,2,100,100,0,1,2,2
2021-12-12,14,DEN,DET,Home,358,316,174,198,2,1,184,118,3,0,2,2
2021-12-19,15,DET,ARI,Home,338,398,212,293,3,1,126,105,0,0,1,1
2021-12-26,16,ATL,DET,Home,254,338,207,208,1,1,47,130,1,0,1,1
2022-01-02,17,SEA,DET,Home,497,357,232,262,4,2,265,95,2,2,3,3
2022-01-09,18,DET,GNB,Home,404,378,305,256,3,3,99,122,1,1,0,0
2022-09-11,1,DET,PHI,Away,386,455,205,239,2,0,181,216,3,4,1,1
2022-09-18,2,DET,WAS,Home,425,396,234,308,4,3,191,88,0,1,0,0
2022-09-25,3,MIN,DET,Home,373,416,250,277,2,1,123,139,2,2,1,1
2022-10-02,4,DET,SEA,Away,520,555,375,320,4,2,145,235,2,3,2,2
2022-10-09,5,NWE,DET,Home,364,312,188,211,1,0,176,101,0,0,2,2
2022-10-23,7,DAL,DET,Home,330,312,191,195,1,0,139,117,2,0,5,5
2022-10-30,8,DET,MIA,Away,393,476,311,369,1,3,82,107,2,1,0,0
2022-11-06,9,DET,GNB,Home,254,389,137,283,2,1,117,106,0,0,1,1
2022-11-13,10,CHI,DET,Away,408,323,150,228,2,1,258,95,2,2,0,0
2022-11-20,11,NYG,DET,Away,413,325,324,165,1,0,89,160,2,4,0,0
2022-11-24,12,DET,BUF,Away,326,401,230,237,2,2,96,164,1,1,2,2
2022-12-04,13,DET,JAX,Home,437,266,337,171,2,1,100,95,2,0,0,0
2022-12-11,14,DET,MIN,Home,464,416,330,394,3,2,134,22,1,1,0,0
2022-12-18,15,NYJ,DET,Away,337,359,287,252,2,1,50,107,0,0,0,0
2022-12-24,16,CAR,DET,Home,570,381,250,336,1,3,320,45,3,0,1,1
2023-01-01,17,DET,CHI,Home,504,230,239,30,3,1,265,200,2,0,0,0
2023-01-08,18,GNB,DET,Away,291,323,188,219,1,0,103,104,0,2,0,0
2023-09-07,1,KAN,DET,Away,316,368,226,250,2,1,90,118,0,1,1,1
2023-09-17,2,DET,SEA,Away,418,393,316,311,3,2,102,82,1,2,3,3
2023-09-24,3,DET,ATL,Home,358,183,243,139,1,0,115,44,1,0,1,1
2023-09-28,4,GNB,DET,Away,230,401,203,190,1,1,27,211,1,3,1,1
2023-10-08,5,DET,CAR,Home,377,342,218,243,3,3,159,99,3,0,0,0
2023-10-15,6,TAM,DET,Away,251,380,205,340,0,2,46,40,0,0,0,0
2023-10-22,7,BAL,DET,Home,503,337,357,253,3,0,146,84,2,1,1,1
2023-10-30,8,DET,LVR,Home,486,157,264,77,1,0,222,80,1,1,3,3
2023-11-12,10,LAC,DET,Away,421,533,323,333,4,2,98,200,1,3,0,0
2023-11-19,11,DET,CHI,Home,338,334,223,151,2,1,115,183,2,1,4,4
2023-11-23,12,DET,GNB,Away,464,377,324,268,2,3,140,109,1,0,3,3
2023-12-03,13,NOR,DET,Away,362,347,249,205,1,2,113,142,3,2,0,0
2023-12-10,14,CHI,DET,Home,336,267,194,127,1,1,142,140,2,1,3,3
2023-12-16,15,DET,DEN,Home,448,287,263,204,5,1,185,83,1,1,0,0
2023-12-24,16,MIN,DET,Away,390,389,373,246,2,1,17,143,1,3,1,1
2023-12-30,17,DAL,DET,Home,384,420,323,295,2,1,61,125,0,1,2,2
2024-01-07,18,DET,MIN,Home,381,448,311,359,2,2,70,89,2,0,0,0
2014-09-04,1,SEA,GNB,Home,398,255,191,175,2,1,207,80,2,1,1,1
2014-09-14,2,GNB,NYJ,Home,390,313,310,166,3,1,80,147,0,2,1,1
2014-09-21,3,DET,GNB,Home,353,223,238,147,0,1,115,76,1,0,1,1
2014-09-28,4,CHI,GNB,Away,496,358,261,302,2,4,235,56,0,1,0,0
2014-10-02,5,GNB,MIN,Home,320,299,164,188,3,0,156,111,2,1,1,1
2014-10-12,6,MIA,GNB,Away,349,369,237,248,2,3,112,121,1,0,0,0
2014-10-19,7,GNB,CAR,Home,363,331,241,223,3,2,122,108,2,0,0,0
2014-10-26,8,NOR,GNB,Home,495,491,302,402,3,1,193,89,2,1,3,3
2014-11-09,10,GNB,CHI,Home,451,311,319,256,6,1,132,55,0,0,1,1
2014-11-16,11,GNB,PHI,Home,475,429,365,320,3,2,110,109,1,0,0,0
2014-11-23,12,MIN,GNB,Away,308,362,196,207,2,2,112,155,0,1,0,0
2014-11-30,13,GNB,NWE,Home,478,320,348,236,2,2,130,84,0,1,0,0
2014-12-08,14,GNB,ATL,Home,502,465,323,374,3,4,179,91,2,1,0,0
2014-12-14,15,BUF,GNB,Home,253,333,140,175,0,0,113,158,0,1,2,2
2014-12-21,16,TAM,GNB,Away,109,431,93,310,0,1,16,121,0,1,1,1
2014-12-28,17,GNB,DET,Home,377,313,225,202,2,3,152,111,1,0,2,2
2015-09-13,1,CHI,GNB,Away,402,322,213,189,1,3,189,133,1,1,0,0
2015-09-20,2,GNB,SEA,Home,361,324,234,205,2,2,127,119,0,0,1,1
2015-09-28,3,GNB,KAN,Home,448,326,325,251,5,1,123,75,0,3,0,0
2015-10-04,4,SFO,GNB,Away,196,362,119,200,0,1,77,162,0,1,0,0
2015-10-11,5,GNB,LAR,Home,322,334,236,143,2,1,86,191,0,0,3,3
2015-10-18,6,GNB,LAC,Home,370,548,237,488,2,2,133,60,1,0,0,0
2015-11-01,8,DEN,GNB,Home,500,140,340,50,0,0,160,90,3,1,0,0
2015-11-08,9,CAR,GNB,Home,427,402,297,331,3,4,130,71,1,0,2,2
2015-11-15,10,GNB,DET,Away,372,287,325,242,2,2,47,45,0,0,0,0
2015-11-22,11,MIN,GNB,Away,342,320,248,196,1,2,94,124,1,0,0,0
2015-11-26,12,GNB,CHI,Away,365,290,188,189,1,1,177,101,0,1,2,2
2015-12-03,13,DET,GNB,Away,306,313,205,246,2,2,101,67,0,1,1,1
2015-12-13,14,GNB,DAL,Home,435,270,205,99,2,0,230,171,2,1,0,0
2015-12-20,15,LVR,GNB,Away,372,293,252,190,2,1,120,103,0,1,2,2
2015-12-27,16,ARI,GNB,Home,381,178,260,77,2,1,121,101,1,0,4,4
2016-01-03,17,GNB,MIN,Away,350,242,274,91,1,0,76,151,0,1,2,2
2016-09-11,1,JAX,GNB,Away,348,294,300,199,1,2,48,95,1,1,0,0
2016-09-18,2,MIN,GNB,Home,284,263,254,180,2,1,30,83,0,1,3,3
2016-09-25,3,GNB,DET,Home,324,418,201,368,4,3,123,50,0,0,0,0
2016-10-09,5,GNB,NYG,Home,406,221,259,178,2,1,147,43,0,0,2,2
2016-10-16,6,GNB,DAL,Away,372,424,294,233,1,3,78,191,0,0,4,4
2016-10-20,7,GNB,CHI,Home,406,189,303,120,3,0,103,69,0,0,1,1
2016-10-30,8,ATL,GNB,Home,367,331,277,223,3,4,90,108,1,0,0,0
2016-11-06,9,GNB,IND,Away,405,355,289,270,3,1,116,85,0,2,1,1
2016-11-13,10,TEN,GNB,Home,446,402,292,333,5,2,154,69,1,1,3,3
2016-11-20,11,WAS,GNB,Home,515,424,364,340,3,3,151,84,3,0,2,2
2016-11-28,12,PHI,GNB,Away,292,387,211,313,0,2,81,74,1,1,0,0
2016-12-04,13,GNB,HOU,Home,309,307,200,184,2,2,109,123,1,0,1,1
2016-12-11,14,GNB,SEA,Home,330,354,237,218,3,1,93,136,2,0,0,0
2016-12-18,15,CHI,GNB,Away,449,451,354,225,2,0,95,226,1,3,0,0
2016-12-24,16,GNB,MIN,Home,348,446,308,353,4,3,40,93,1,0,0,0
2017-01-01,17,DET,GNB,Away,408,448,332,295,2,4,76,153,1,0,0,0
2017-09-10,1,GNB,SEA,Home,370,225,286,135,1,0,84,90,1,0,1,1
2017-09-17,2,ATL,GNB,Home,364,367,223,308,1,2,141,59,2,1,2,2
2017-09-24,3,GNB,CIN,Home,344,301,280,191,3,2,64,110,0,0,1,1
2017-09-28,4,GNB,CHI,Home,260,308,169,205,4,1,91,103,1,1,0,0
2017-10-08,5,DAL,GNB,Away,408,342,245,182,3,3,163,160,1,1,1,1
2017-10-15,6,MIN,GNB,Home,351,227,239,155,1,1,112,72,1,0,3,3
2017-10-22,7,GNB,NOR,Away,260,485,79,324,0,1,181,161,2,2,1,1
2017-11-06,9,GNB,DET,Away,311,417,233,353,0,2,78,64,2,1,0,0
2017-11-12,10,CHI,GNB,Away,323,342,268,182,1,1,55,160,0,1,0,0
2017-11-19,11,GNB,BAL,Away,265,219,190,161,0,1,75,58,0,1,5,5
2017-11-26,12,PIT,GNB,Home,462,307,341,227,4,3,121,80,0,1,0,0
2017-12-03,13,GNB,TAM,Home,276,395,77,230,0,2,199,165,2,0,1,1
2017-12-10,14,CLE,GNB,Away,345,341,209,256,3,3,136,85,0,1,0,0
2017-12-17,15,CAR,GNB,Home,387,384,236,264,4,3,151,120,0,0,4,4
2017-12-23,16,GNB,MIN,Away,239,236,126,124,0,1,113,112,0,0,2,2
2017-12-31,17,DET,GNB,Home,356,256,305,153,3,1,51,103,1,0,4,4
2018-09-09,1,GNB,CHI,Home,370,294,301,155,3,0,69,139,0,1,2,2
2018-09-16,2,GNB,MIN,Away,351,480,253,412,1,4,98,68,0,0,0,0
2018-09-23,3,WAS,GNB,Home,386,340,220,240,2,2,166,100,2,0,1,1
2018-09-30,4,GNB,BUF,Home,423,145,282,87,1,0,141,58,1,0,2,2
2018-10-07,5,DET,GNB,Home,264,521,170,423,2,3,94,98,2,0,3,3
2018-10-15,6,GNB,SFO,Home,521,401,405,227,2,2,116,174,1,1,0,0
2018-10-28,8,LAR,GNB,Home,416,359,281,253,3,1,135,106,0,2,1,1
2018-11-04,9,NWE,GNB,Home,433,367,310,250,1,2,123,117,3,0,1,1
2018-11-11,10,GNB,MIA,Home,377,294,182,163,2,0,195,131,2,0,1,1
2018-11-15,11,SEA,GNB,Home,378,359,205,311,2,2,173,48,1,1,0,0
2018-11-25,12,MIN,GNB,Home,416,254,325,172,3,1,91,82,0,1,1,1
2018-12-02,13,GNB,ARI,Away,325,315,227,133,1,0,98,182,1,2,0,0
2018-12-09,14,GNB,ATL,Home,300,344,162,237,2,3,138,107,1,0,0,0
2018-12-16,15,CHI,GNB,Home,332,323,232,235,2,0,100,88,1,1,1,1
2018-12-23,16,NYJ,GNB,Away,370,540,323,413,3,2,47,127,1,3,1,1
2018-12-30,17,GNB,DET,Away,175,402,129,272,0,3,46,130,0,1,1,1
2019-09-05,1,CHI,GNB,Away,254,213,208,166,0,1,46,47,0,0,0,0
2019-09-15,2,GNB,MIN,Home,335,421,191,223,2,1,144,198,1,1,2,2
2019-09-22,3,GNB,DEN,Home,312,310,235,161,1,0,77,149,2,2,0,0
2019-09-26,4,GNB,PHI,Away,491,336,414,160,2,3,77,176,1,2,2,2
2019-10-06,5,DAL,GNB,Away,563,335,441,215,2,0,122,120,1,4,0,0
2019-10-14,6,GNB,DET,Home,447,299,277,243,2,0,170,56,0,1,3,3
2019-10-20,7,GNB,LVR,Home,481,484,421,329,5,3,60,155,1,0,0,0
2019-10-27,8,KAN,GNB,Away,337,374,249,256,2,3,88,118,1,1,0,0
2019-11-03,9,LAC,GNB,Home,442,184,283,139,0,1,159,45,2,0,0,0
2019-11-10,10,GNB,CAR,Home,388,401,225,281,0,1,163,120,3,1,0,0
2019-11-24,12,SFO,GNB,Home,339,198,227,81,2,1,112,117,2,0,1,1
2019-12-01,13,NYG,GNB,Away,335,322,240,243,1,4,95,79,0,0,0,0
2019-12-08,14,GNB,WAS,Home,341,262,167,141,1,1,174,121,1,1,1,1
2019-12-15,15,GNB,CHI,Home,292,415,192,319,1,1,100,96,2,0,0,0
2019-12-23,16,MIN,GNB,Away,139,383,82,199,1,0,57,184,0,2,3,3
2019-12-29,17,DET,GNB,Away,305,432,134,312,1,2,171,120,1,0,1,1
2020-09-13,1,MIN,GNB,Away,382,522,248,364,2,4,134,158,2,1,0,0
2020-09-20,2,GNB,DET,Home,488,307,229,218,2,2,259,89,2,1,0,0
2020-09-27,3,NOR,GNB,Away,397,369,275,271,3,3,122,98,0,1,0,0
2020-10-05,4,GNB,ATL,Home,403,327,315,249,4,0,88,78,0,2,0,0
2020-10-18,6,TAM,GNB,Home,324,201,166,107,2,0,158,94,2,1,2,2
2020-10-25,7,HOU,GNB,Away,365,379,286,283,2,4,79,96,0,1,0,0
2020-11-01,8,GNB,MIN,Away,400,324,291,151,3,1,109,173,0,3,1,1
2020-11-05,9,SFO,GNB,Away,337,405,282,294,1,4,55,111,1,0,0,0
2020-11-15,10,GNB,JAX,Home,395,260,315,151,2,1,80,109,1,0,2,2
2020-11-22,11,IND,GNB,Home,420,367,280,301,3,3,140,66,0,1,4,4
2020-11-29,12,GNB,CHI,Home,393,350,211,229,4,3,182,121,1,0,0,0
2020-12-06,13,GNB,PHI,Home,437,278,288,161,3,1,149,117,1,0,0,0
2020-12-13,14,DET,GNB,Away,293,410,242,290,1,3,51,120,2,1,0,0
2020-12-19,15,GNB,CAR,Home,291,364,96,249,1,0,195,115,2,1,0,0
2020-12-27,16,GNB,TEN,Home,448,260,214,104,4,1,234,156,2,1,1,1
2021-01-03,17,CHI,GNB,Away,356,316,248,237,0,4,108,79,1,1,1,1
2021-09-12,1,NOR,GNB,Home,322,229,151,186,5,0,171,43,0,0,3,3
2021-09-20,2,GNB,DET,Home,323,344,227,236,4,2,96,108,1,0,0,0
2021-09-26,3,SFO,GNB,Away,298,353,231,253,2,2,67,100,2,1,0,0
2021-10-03,4,GNB,PIT,Home,367,282,236,220,2,1,131,62,1,1,1,1
2021-10-10,5,CIN,GNB,Away,367,466,264,333,2,2,103,133,1,0,1,1
2021-10-17,6,CHI,GNB,Away,277,323,137,169,1,2,140,154,1,1,0,0
2021-10-24,7,GNB,WAS,Home,304,430,247,235,3,1,57,195,0,0,1,1
2021-10-28,8,ARI,GNB,Away,334,335,260,184,0,2,74,151,3,1,0,0
2021-11-07,9,KAN,GNB,Home,237,301,160,179,1,1,77,122,0,0,2,2
2021-11-14,10,GNB,SEA,Home,393,208,287,133,0,0,106,75,2,0,1,1
2021-11-21,11,MIN,GNB,Home,408,467,318,372,3,4,90,95,1,0,0,0
2021-11-28,12,GNB,LAR,Home,399,353,307,285,2,3,92,68,1,0,1,1
2021-12-12,14,GNB,CHI,Home,439,347,320,210,4,2,119,137,1,0,0,0
2021-12-19,15,BAL,GNB,Away,354,346,211,250,2,3,143,96,2,1,0,0
2021-12-25,16,GNB,CLE,Home,311,408,202,189,3,2,109,219,0,1,0,0
2022-01-02,17,GNB,MIN,Home,481,206,307,179,2,1,174,27,2,0,0,0
2022-01-09,18,DET,GNB,Home,404,378,305,256,3,3,99,122,1,1,3,3
2022-09-11,1,MIN,GNB,Home,395,338,269,227,2,0,126,111,0,1,2,2
2022-09-18,2,GNB,CHI,Home,414,228,211,48,2,0,203,180,1,1,1,1
2022-09-25,3,TAM,GNB,Away,285,315,251,248,1,2,34,67,0,0,2,2
2022-10-02,4,GNB,NWE,Home,443,271,244,104,2,1,199,167,1,1,2,2
2022-10-09,5,GNB,NYG,Away,301,338,207,213,2,0,94,125,0,3,0,0
2022-10-16,6,GNB,NYJ,Away,278,278,218,99,1,0,60,179,0,2,1,1
2022-10-23,7,WAS,GNB,Home,364,232,198,194,2,2,166,38,0,0,1,1
2022-10-30,8,BUF,GNB,Home,369,398,216,190,2,2,153,208,1,0,1,1
2022-11-06,9,DET,GNB,Home,254,389,137,283,2,1,117,106,0,0,3,3
2022-11-13,10,GNB,DAL,Home,415,421,208,262,3,3,207,159,1,1,2,2
2022-11-17,11,GNB,TEN,Away,271,408,215,320,2,3,56,88,0,1,0,0
2022-11-27,12,PHI,GNB,Home,500,342,137,236,2,3,363,106,3,1,2,2
2022-12-04,13,CHI,GNB,Away,409,357,254,182,0,1,155,175,2,2,0,0
2022-12-19,15,GNB,LAR,Home,345,156,207,84,1,1,138,72,2,0,2,2
2022-12-25,16,MIA,GNB,Away,376,301,294,222,1,1,82,79,1,1,1,1
2023-01-01,17,GNB,MIN,Home,315,346,152,244,1,2,163,102,2,0,0,0
2023-01-08,18,GNB,DET,Away,291,323,188,219,1,0,103,104,0,2,2,2
2023-09-10,1,CHI,GNB,Away,311,329,189,237,1,3,122,92,1,1,0,0
2023-09-17,2,ATL,GNB,Home,446,224,235,140,1,3,211,84,1,0,0,0
2023-09-24,3,GNB,NOR,Home,340,252,245,175,1,1,95,77,1,0,1,1
2023-09-28,4,GNB,DET,Away,230,401,203,190,1,1,27,211,1,3,2,2
2023-10-09,5,LVR,GNB,Home,279,285,183,175,1,0,96,110,1,1,3,3
2023-10-22,7,DEN,GNB,Home,339,331,194,194,1,2,145,137,0,0,1,1
2023-10-29,8,GNB,MIN,Away,270,346,196,284,1,2,74,62,0,1,1,1
2023-11-05,9,GNB,LAR,Home,391,187,207,119,1,0,184,68,1,0,2,2
2023-11-12,10,PIT,GNB,Home,324,399,119,283,0,2,205,116,2,0,2,2
2023-11-19,11,GNB,LAC,Home,397,394,295,244,2,2,102,150,1,0,0,0
2023-11-23,12,DET,GNB,Away,464,377,324,268,2,3,140,109,1,0,0,0
2023-12-03,13,GNB,KAN,Home,382,337,253,189,3,1,129,148,0,1,0,0
2023-12-11,14,NYG,GNB,Home,367,326,158,203,1,1,209,123,2,1,3,3
2023-12-17,15,GNB,TAM,Away,321,452,261,353,2,4,60,99,0,0,1,1
2023-12-24,16,CAR,GNB,Away,394,369,298,207,2,2,96,162,2,2,0,0
2023-12-31,17,MIN,GNB,Away,211,470,144,293,1,3,67,177,0,1,1,1
2024-01-07,18,GNB,CHI,Home,432,192,308,117,2,0,124,75,0,0,1,1
2014-09-07,1,HOU,WAS,Home,321,372,206,241,1,0,115,131,0,1,1,1
2014-09-14,2,LVR,HOU,Away,364,327,263,139,1,2,101,188,1,1,0,0
2014-09-21,3,NYG,HOU,Home,419,411,226,292,2,1,193,119,1,1,3,3
2014-09-28,4,HOU,BUF,Home,301,316,264,220,1,2,37,96,0,0,3,3
2014-10-05,5,DAL,HOU,Home,456,330,316,154,2,0,140,176,0,2,1,1
2014-10-09,6,HOU,IND,Away,332,456,196,363,1,3,136,93,2,1,2,2
2014-10-20,7,PIT,HOU,Home,328,393,252,261,3,2,76,132,0,0,3,3
2014-10-26,8,TEN,HOU,Away,326,405,290,193,2,1,36,212,0,2,0,0
2014-11-02,9,HOU,PHI,Away,300,483,182,293,2,3,118,190,0,1,1,1
2014-11-16,11,CLE,HOU,Away,375,424,310,211,1,2,65,213,0,0,1,1
2014-11-23,12,HOU,CIN,Away,248,372,184,233,0,1,64,139,0,1,1,1
2014-11-30,13,HOU,TEN,Home,457,320,358,237,6,2,99,83,0,0,1,1
2014-12-07,14,JAX,HOU,Away,262,304,188,135,1,0,74,169,0,3,0,0
2014-12-14,15,IND,HOU,Home,278,289,168,152,2,0,110,137,0,0,2,2
2014-12-21,16,HOU,BAL,Home,313,211,190,178,1,2,123,33,0,0,1,1
2014-12-28,17,HOU,JAX,Home,358,233,235,112,2,1,123,121,1,0,2,2
2015-09-13,1,HOU,KAN,Away,396,330,298,233,2,3,98,97,0,0,2,2
2015-09-20,2,CAR,HOU,Home,350,300,178,239,2,1,172,61,1,1,1,1
2015-09-27,3,HOU,TAM,Home,413,318,227,261,1,1,186,57,1,0,1,1
2015-10-04,4,ATL,HOU,Home,378,428,243,374,1,2,135,54,4,1,4,4
2015-10-08,5,HOU,IND,Away,444,323,362,213,2,2,82,110,0,1,2,2
2015-10-18,6,JAX,HOU,Away,394,382,311,287,3,3,83,95,0,0,0,0
2015-10-25,7,MIA,HOU,Home,503,322,255,251,4,3,248,71,1,1,1,1
2015-11-01,8,HOU,TEN,Home,270,211,214,125,2,0,56,86,0,0,0,0
2015-11-16,10,CIN,HOU,Away,256,256,182,174,0,1,74,82,0,0,1,1
2015-11-22,11,HOU,NYJ,Home,364,267,241,197,3,1,123,70,0,1,1,1
2015-11-29,12,HOU,NOR,Home,362,268,195,218,2,0,167,50,1,0,1,1
2015-12-06,13,BUF,HOU,Home,390,401,203,275,3,3,187,126,1,0,1,1
2015-12-13,14,HOU,NWE,Away,189,313,102,197,0,2,87,116,0,1,1,1
2015-12-20,15,IND,HOU,Away,190,305,140,150,1,1,50,155,0,0,2,2
2015-12-27,16,TEN,HOU,Away,257,330,227,202,1,2,30,128,0,1,1,1
2016-01-03,17,HOU,JAX,Home,402,215,242,183,1,0,160,32,1,0,1,1
2016-09-11,1,HOU,CHI,Home,344,258,215,185,2,1,129,73,0,1,1,1
2016-09-18,2,HOU,KAN,Home,351,291,254,172,1,0,97,119,0,0,2,2
2016-09-22,3,NWE,HOU,Home,282,284,97,175,0,0,185,109,3,0,3,3
2016-10-02,4,HOU,TEN,Home,359,320,244,196,2,0,115,124,0,2,2,2
2016-10-09,5,MIN,HOU,Home,351,214,255,155,2,1,96,59,1,0,1,1
2016-10-16,6,HOU,IND,Home,414,392,256,231,2,1,158,161,1,1,1,1
2016-10-24,7,DEN,HOU,Home,347,271,157,131,1,0,190,140,2,0,2,2
2016-10-30,8,HOU,DET,Home,269,289,164,231,1,1,105,58,1,0,1,1
2016-11-13,10,JAX,HOU,Away,327,273,247,92,2,2,80,181,0,0,0,0
2016-11-21,11,LVR,HOU,Home,325,354,295,230,3,1,30,124,0,1,2,2
2016-11-27,12,HOU,LAC,Away,353,302,239,235,0,3,114,67,1,0,4,4
2016-12-04,13,GNB,HOU,Home,309,307,200,184,2,2,109,123,1,0,1,1
2016-12-11,14,IND,HOU,Away,348,316,265,131,2,0,83,185,0,1,1,1
2016-12-18,15,HOU,JAX,Home,387,150,308,83,0,0,79,67,1,1,2,2
2016-12-24,16,HOU,CIN,Home,250,294,155,244,0,1,95,50,1,0,0,0
2017-01-01,17,TEN,HOU,Home,236,289,133,243,1,1,103,46,1,1,1,1
2017-09-10,1,HOU,JAX,Away,203,280,110,125,1,1,93,155,0,1,4,4
2017-09-14,2,CIN,HOU,Away,295,266,213,98,0,0,82,168,0,1,0,0
2017-09-24,3,NWE,HOU,Home,396,417,337,292,5,2,59,125,0,0,2,2
2017-10-01,4,HOU,TEN,Home,445,195,272,109,4,0,173,86,2,2,1,1
2017-10-08,5,HOU,KAN,Away,392,450,248,323,5,3,144,127,0,0,1,1
2017-10-15,6,HOU,CLE,Home,340,247,217,113,3,1,123,134,0,0,1,1
2017-10-29,8,SEA,HOU,Home,479,509,446,367,4,4,33,142,0,1,3,3
2017-11-05,9,HOU,IND,Away,288,371,194,279,1,2,94,92,0,0,1,1
2017-11-12,10,LAR,HOU,Home,443,283,339,194,3,1,104,89,0,0,4,4
2017-11-19,11,HOU,ARI,Home,357,292,223,244,2,3,134,48,2,0,2,2
2017-11-27,12,BAL,HOU,Home,294,303,155,237,0,0,139,66,2,1,3,3
2017-12-03,13,TEN,HOU,Home,344,384,146,331,1,1,198,53,2,0,1,1
2017-12-10,14,HOU,SFO,Away,311,416,221,314,2,1,90,102,0,1,1,1
2017-12-17,15,JAX,HOU,Home,464,186,326,99,3,1,138,87,3,0,1,1
2017-12-25,16,HOU,PIT,Away,227,330,51,226,1,2,176,104,0,2,2,2
2017-12-31,17,IND,HOU,Home,250,209,104,124,1,0,146,85,1,1,1,1
2018-09-09,1,NWE,HOU,Home,389,325,267,158,3,1,122,167,0,1,2,2
2018-09-16,2,TEN,HOU,Home,283,437,183,289,2,2,100,148,0,0,1,1
2018-09-23,3,HOU,NYG,Away,427,379,368,265,2,2,59,114,0,1,2,2
2018-09-30,4,IND,HOU,Away,478,466,437,347,4,2,41,119,0,1,1,1
2018-10-07,5,HOU,DAL,Home,462,292,374,194,1,1,88,98,0,0,2,2
2018-10-14,6,HOU,BUF,Home,216,229,142,129,1,1,74,100,0,0,3,3
2018-10-21,7,JAX,HOU,Away,259,272,189,131,1,1,70,141,0,1,0,0
2018-10-25,8,HOU,MIA,Home,427,370,239,254,5,1,188,116,1,1,0,0
2018-11-04,9,DEN,HOU,Away,348,290,273,192,1,2,75,98,1,0,0,0
2018-11-18,11,WAS,HOU,Away,278,320,154,181,1,1,124,139,2,0,3,3
2018-11-26,12,HOU,TEN,Home,462,365,181,260,2,2,281,105,2,0,0,0
2018-12-02,13,HOU,CLE,Home,384,428,197,397,1,1,187,31,0,1,0,0
2018-12-09,14,HOU,IND,Away,315,436,226,386,1,2,89,50,2,1,0,0
2018-12-15,15,NYJ,HOU,Away,318,286,228,239,2,2,90,47,1,0,0,0
2018-12-23,16,PHI,HOU,Home,519,371,462,309,4,2,57,62,0,2,1,1
2018-12-30,17,HOU,JAX,Home,342,119,208,89,0,0,134,30,2,0,1,1
2019-09-09,1,NOR,HOU,Home,510,414,362,234,2,3,148,180,1,1,1,1
2019-09-15,2,HOU,JAX,Home,263,281,137,178,0,1,126,103,1,0,0,0
2019-09-22,3,LAC,HOU,Away,366,376,293,337,2,3,73,39,0,1,1,1
2019-09-29,4,HOU,CAR,Away,264,297,128,203,0,0,136,94,1,1,2,2
2019-10-06,5,HOU,ATL,Home,592,373,426,316,5,3,166,57,1,1,1,1
2019-10-13,6,KAN,HOU,Away,309,472,256,280,3,1,53,192,0,3,3,3
2019-10-20,7,IND,HOU,Home,383,391,321,291,4,1,62,100,0,1,2,2
2019-10-27,8,HOU,LVR,Home,388,378,258,285,3,3,130,93,0,0,0,0
2019-11-03,9,JAX,HOU,Away,356,410,282,194,0,2,74,216,0,1,1,1
2019-11-17,11,BAL,HOU,Home,491,232,235,110,4,0,256,122,1,1,2,2
2019-11-21,12,HOU,IND,Home,396,296,297,121,2,0,99,175,0,2,1,1
2019-12-01,13,HOU,NWE,Home,276,448,224,303,4,3,52,145,0,0,0,0
2019-12-08,14,HOU,DEN,Away,414,391,280,301,1,3,134,90,2,1,3,3
2019-12-15,15,TEN,HOU,Away,432,374,269,234,2,2,163,140,1,1,2,2
2019-12-21,16,TAM,HOU,Away,435,229,329,161,1,0,106,68,1,1,2,2
2019-12-29,17,HOU,TEN,Away,301,467,192,222,0,2,109,245,2,3,1,1
2020-09-10,1,KAN,HOU,Home,369,360,203,242,3,1,166,118,1,2,1,1
2020-09-20,2,HOU,BAL,Away,304,407,253,177,1,1,51,230,0,1,2,2
2020-09-27,3,PIT,HOU,Home,387,260,218,231,2,2,169,29,1,1,1,1
2020-10-04,4,HOU,MIN,Away,386,410,290,248,2,1,96,162,0,3,1,1
2020-10-11,5,HOU,JAX,Home,486,364,357,289,3,2,129,75,0,0,2,2
2020-10-18,6,TEN,HOU,Home,607,412,344,320,4,4,263,92,2,1,0,0
2020-10-25,7,HOU,GNB,Away,365,379,286,283,2,4,79,96,0,1,1,1
2020-11-08,9,JAX,HOU,Away,403,374,288,267,1,2,115,107,2,1,1,1
2020-11-15,10,CLE,HOU,Home,356,243,125,153,0,1,231,90,1,0,0,0
2020-11-22,11,HOU,NWE,Home,399,435,344,349,2,1,55,86,1,1,0,0
2020-11-26,12,DET,HOU,Away,388,384,279,307,1,4,109,77,2,0,1,1
2020-12-06,13,HOU,IND,Away,398,371,308,262,0,2,90,109,2,1,2,2
2020-12-13,14,CHI,HOU,Home,410,263,241,155,3,1,169,108,1,0,2,2
2020-12-20,15,IND,HOU,Home,350,425,223,342,2,2,127,83,1,0,2,2
2020-12-27,16,HOU,CIN,Away,488,540,322,371,3,2,166,169,1,2,1,1
2021-01-03,17,HOU,TEN,Away,457,492,361,204,3,1,96,288,1,4,1,1
2021-09-12,1,HOU,JAX,Home,449,395,289,319,2,3,160,76,2,0,0,0
2021-09-19,2,CLE,HOU,Home,355,302,199,220,1,2,156,82,3,1,2,2
2021-09-23,3,HOU,CAR,Away,193,407,151,290,1,0,42,117,0,3,0,0
2021-10-03,4,BUF,HOU,Home,450,109,251,61,2,0,199,48,2,0,5,5
2021-10-10,5,HOU,NWE,Away,360,352,293,226,3,1,67,126,0,1,1,1
2021-10-17,6,IND,HOU,Home,388,353,214,229,2,0,174,124,2,0,3,3
2021-10-24,7,ARI,HOU,Home,397,160,225,118,3,0,172,42,1,0,1,1
2021-10-31,8,HOU,LAR,Away,323,467,279,302,2,3,44,165,1,2,1,1
2021-11-07,9,MIA,HOU,Home,262,272,215,199,1,0,47,73,1,0,4,4
2021-11-21,11,TEN,HOU,Away,420,190,317,107,1,0,103,83,0,2,0,0
2021-11-28,12,HOU,NYJ,Away,202,266,106,109,2,0,96,157,0,2,1,1
2021-12-05,13,HOU,IND,Away,141,389,57,151,0,1,84,238,0,3,2,2
2021-12-12,14,HOU,SEA,Away,380,453,317,260,1,2,63,193,0,2,0,0
2021-12-19,15,JAX,HOU,Away,296,281,189,206,0,2,107,75,1,0,1,1
2021-12-26,16,HOU,LAC,Home,437,417,248,328,2,1,189,89,2,2,0,0
2022-01-02,17,SFO,HOU,Home,416,222,241,136,2,1,175,86,0,0,1,1
2022-01-09,18,HOU,TEN,Away,353,405,289,281,3,4,64,124,0,0,0,0
2022-09-11,1,HOU,IND,Away,299,517,222,340,2,1,77,177,0,1,1,1
2022-09-18,2,DEN,HOU,Home,350,234,201,154,1,0,149,80,0,0,0,0
2022-09-25,3,CHI,HOU,Home,363,329,82,237,0,1,281,92,2,1,2,2
2022-10-02,4,HOU,LAC,Away,346,419,215,338,2,2,131,81,1,2,2,2
2022-10-09,5,JAX,HOU,Away,422,248,286,132,0,0,136,116,0,1,0,0
2022-10-23,7,LVR,HOU,Home,400,404,236,296,1,2,164,108,3,0,1,1
2022-10-30,8,HOU,TEN,Away,161,354,118,40,1,0,43,314,0,2,1,1
2022-11-03,9,HOU,PHI,Away,303,360,135,217,2,2,168,143,0,2,2,2
2022-11-13,10,NYG,HOU,Home,367,387,176,286,2,1,191,101,1,0,2,2
2022-11-20,11,HOU,WAS,Away,148,344,127,191,0,0,21,153,1,1,2,2
2022-11-27,12,MIA,HOU,Home,339,210,273,174,1,1,66,36,1,1,3,3
2022-12-04,13,HOU,CLE,Away,283,304,201,130,1,0,82,174,0,0,4,4
2022-12-11,14,DAL,HOU,Home,404,327,277,213,1,1,127,114,2,1,2,2
2022-12-18,15,HOU,KAN,Away,219,502,125,313,2,2,94,189,1,2,1,1
2022-12-24,16,TEN,HOU,Away,272,285,88,215,0,1,184,70,2,0,1,1
2023-01-01,17,HOU,JAX,Away,277,337,193,168,0,0,84,169,0,3,1,1
2023-01-08,18,IND,HOU,Away,398,360,202,301,2,3,196,59,1,0,3,3
2023-09-10,1,BAL,HOU,Home,265,268,155,196,0,0,110,72,3,0,1,1
2023-09-17,2,HOU,IND,Away,389,353,337,227,2,1,52,126,0,3,1,1
2023-09-24,3,JAX,HOU,Away,404,366,288,280,1,2,116,86,1,1,0,0
2023-10-01,4,HOU,PIT,Home,451,225,312,111,3,0,139,114,0,0,0,0
2023-10-08,5,ATL,HOU,Home,447,313,351,249,1,1,96,64,1,0,0,0
2023-10-15,6,HOU,NOR,Home,297,430,177,341,2,1,120,89,0,0,1,1
2023-10-29,8,CAR,HOU,Home,224,229,180,119,1,0,44,110,0,2,1,1
2023-11-05,9,HOU,TAM,Home,496,332,443,251,5,2,53,81,0,2,1,1
2023-11-12,10,CIN,HOU,Away,380,544,314,356,2,1,66,188,1,2,3,3
2023-11-19,11,HOU,ARI,Home,419,319,308,196,2,1,111,123,1,1,3,3
2023-11-26,12,HOU,JAX,Away,352,445,261,364,2,1,91,81,1,1,0,0
2023-12-03,13,HOU,DEN,Home,353,282,264,164,1,1,89,118,1,1,0,0
2023-12-10,14,NYJ,HOU,Home,347,135,268,54,2,0,79,81,1,1,0,0
2023-12-17,15,TEN,HOU,Away,204,340,138,192,0,1,66,148,1,0,1,1
2023-12-24,16,HOU,CLE,Away,250,418,178,364,2,3,72,54,0,2,2,2
2023-12-31,17,HOU,TEN,Home,312,187,201,134,1,0,111,53,0,0,0,0
2024-01-06,18,IND,HOU,Away,360,306,133,246,0,2,227,60,1,1,0,0
2014-09-07,1,DEN,IND,Home,361,408,259,354,3,2,102,54,1,1,2,2
2014-09-15,2,IND,PHI,Away,341,458,172,331,3,1,169,127,0,2,2,2
2014-09-21,3,JAX,IND,Away,344,529,239,385,2,4,105,144,0,0,0,0
2014-09-28,4,IND,TEN,Home,498,261,393,176,4,1,105,85,1,1,1,1
2014-10-05,5,IND,BAL,Home,432,287,305,197,1,0,127,90,1,1,4,4
2014-10-09,6,HOU,IND,Away,332,456,196,363,1,3,136,93,2,1,2,2
2014-10-19,7,IND,CIN,Home,506,135,335,103,2,0,171,32,1,0,2,2
2014-10-26,8,PIT,IND,Home,639,448,522,385,6,3,117,63,0,1,2,2
2014-11-03,9,NYG,IND,Away,438,443,349,345,2,4,89,98,1,0,0,0
2014-11-16,11,IND,NWE,Away,322,503,303,257,2,2,19,246,0,4,1,1
2014-11-23,12,IND,JAX,Home,389,194,214,114,1,0,175,80,1,0,3,3
2014-11-30,13,IND,WAS,Home,487,425,361,341,5,3,126,84,1,0,3,3
2014-12-07,14,CLE,IND,Away,248,362,133,269,0,2,115,93,1,1,4,4
2014-12-14,15,IND,HOU,Home,278,289,168,152,2,0,110,137,0,0,2,2
2014-12-21,16,DAL,IND,Home,377,229,250,228,5,1,127,1,1,0,3,3
2014-12-28,17,TEN,IND,Away,192,378,50,314,1,3,142,64,0,0,0,0
2015-09-13,1,BUF,IND,Home,342,304,195,240,1,2,147,64,2,0,3,3
2015-09-21,2,IND,NYJ,Away,343,344,250,243,1,2,93,101,0,0,5,5
2015-09-27,3,TEN,IND,Away,433,378,345,245,2,2,88,133,2,2,2,2
2015-10-04,4,IND,JAX,Home,326,431,266,289,1,1,60,142,0,0,2,2
2015-10-08,5,HOU,IND,Away,444,323,362,213,2,2,82,110,0,1,0,0
2015-10-18,6,IND,NWE,Away,409,417,289,301,3,3,120,116,0,1,0,0
2015-10-25,7,IND,NOR,Away,376,449,301,266,3,1,75,183,0,3,3,3
2015-11-02,8,CAR,IND,Home,379,359,239,223,2,2,140,136,1,0,4,4
2015-11-08,9,IND,DEN,Home,365,309,245,274,2,2,120,35,1,0,0,0
2015-11-22,11,ATL,IND,Away,375,276,275,202,3,2,100,74,0,0,3,3
2015-11-29,12,IND,TAM,Home,336,344,309,212,2,1,27,132,0,0,0,0
2015-12-06,13,PIT,IND,Home,522,240,364,186,4,1,158,54,0,0,3,3
2015-12-13,14,JAX,IND,Home,380,322,226,227,3,0,154,95,2,0,2,2
2015-12-20,15,IND,HOU,Away,190,305,140,150,1,1,50,155,0,0,2,2
2015-12-27,16,MIA,IND,Away,361,268,279,168,0,0,82,100,1,2,0,0
2016-01-03,17,IND,TEN,Home,327,231,200,94,2,1,127,137,0,2,1,1
2016-09-11,1,IND,DET,Away,450,448,368,332,4,3,82,116,0,2,0,0
2016-09-18,2,DEN,IND,Home,400,253,266,170,0,1,134,83,1,1,2,2
2016-09-25,3,IND,LAC,Home,410,352,317,315,1,0,93,37,2,1,2,2
2016-10-02,4,JAX,IND,Home,331,284,195,190,2,2,136,94,1,1,1,1
2016-10-09,5,IND,CHI,Home,396,522,298,397,2,2,98,125,0,0,0,0
2016-10-16,6,HOU,IND,Home,414,392,256,231,2,1,158,161,1,1,1,1
2016-10-23,7,TEN,IND,Away,331,422,207,341,2,3,124,81,1,0,0,0
2016-10-30,8,IND,KAN,Away,277,422,172,334,2,3,105,88,0,0,2,2
2016-11-06,9,GNB,IND,Away,405,355,289,270,3,1,116,85,0,2,2,2
2016-11-20,11,IND,TEN,Home,327,351,251,254,2,2,76,97,1,0,1,1
2016-11-24,12,IND,PIT,Away,310,369,219,221,1,3,91,148,0,1,2,2
2016-12-05,13,NYJ,IND,Away,250,421,214,282,1,4,36,139,0,1,1,1
2016-12-11,14,IND,HOU,Away,348,316,265,131,2,0,83,185,0,1,3,3
2016-12-18,15,MIN,IND,Away,282,411,248,250,0,2,34,161,0,2,0,0
2016-12-24,16,LVR,IND,Home,463,390,253,288,3,2,210,102,2,1,3,3
2017-01-01,17,IND,JAX,Home,384,470,290,288,2,1,94,182,1,1,2,2
2017-09-10,1,LAR,IND,Home,373,225,310,150,1,0,63,75,2,1,3,3
2017-09-17,2,IND,ARI,Away,266,389,190,306,0,1,76,83,1,0,1,1
2017-09-24,3,IND,CLE,Home,335,346,243,235,1,2,92,111,3,2,1,1
2017-10-01,4,SEA,IND,Home,477,237,283,139,2,1,194,98,2,1,2,2
2017-10-08,5,IND,SFO,Home,447,402,288,336,0,2,159,66,2,0,1,1
2017-10-16,6,TEN,IND,Home,473,297,305,212,1,1,168,85,2,0,1,1
2017-10-22,7,IND,JAX,Away,232,518,136,330,0,1,96,188,0,2,0,0
2017-10-29,8,CIN,IND,Home,276,331,218,216,2,2,58,115,0,0,1,1
2017-11-05,9,HOU,IND,Away,288,371,194,279,1,2,94,92,0,0,1,1
2017-11-12,10,IND,PIT,Away,267,316,196,228,2,2,71,88,0,0,1,1
2017-11-26,12,IND,TEN,Away,254,276,165,184,0,1,89,92,1,1,1,1
2017-12-03,13,JAX,IND,Home,426,290,330,149,2,1,96,141,1,0,2,2
2017-12-10,14,BUF,IND,Home,319,227,92,64,1,1,227,163,1,0,0,0
2017-12-14,15,IND,DEN,Away,228,462,158,251,0,2,70,211,1,1,0,0
2017-12-23,16,BAL,IND,Home,323,296,220,203,2,1,103,93,0,0,0,0
2017-12-31,17,IND,HOU,Home,250,209,104,124,1,0,146,85,1,1,0,0
2018-09-09,1,IND,CIN,Away,380,330,305,229,2,2,75,101,0,1,2,2
2018-09-16,2,WAS,IND,Away,334,281,269,177,0,2,65,104,0,1,2,2
2018-09-23,3,PHI,IND,Home,379,209,227,141,1,1,152,68,1,0,0,0
2018-09-30,4,IND,HOU,Away,478,466,437,347,4,2,41,119,0,1,2,2
2018-10-04,5,NWE,IND,Home,438,439,341,355,3,3,97,84,2,0,3,3
2018-10-14,6,NYJ,IND,Home,374,428,267,301,2,4,107,127,0,0,4,4
2018-10-21,7,IND,BUF,Home,376,303,156,168,4,0,220,135,1,0,0,0
2018-10-28,8,LVR,IND,Away,347,461,244,239,3,3,103,222,1,2,0,0
2018-11-11,10,IND,JAX,Home,366,415,285,324,3,2,81,91,1,1,1,1
2018-11-18,11,IND,TEN,Home,397,267,295,176,3,1,102,91,2,0,0,0
2018-11-25,12,IND,MIA,Home,455,314,337,201,3,2,118,113,0,1,3,3
2018-12-02,13,JAX,IND,Home,211,265,132,224,0,0,79,41,0,0,2,2
2018-12-09,14,HOU,IND,Away,315,436,226,386,1,2,89,50,2,1,1,1
2018-12-16,15,IND,DAL,Home,370,292,192,180,0,0,178,112,2,0,1,1
2018-12-23,16,IND,NYG,Home,402,392,353,309,2,1,49,83,2,2,1,1
2018-12-30,17,TEN,IND,Away,258,436,165,278,1,3,93,158,0,1,2,2
2019-09-08,1,LAC,IND,Home,435,376,310,173,3,2,125,203,1,1,0,0
2019-09-15,2,TEN,IND,Away,243,288,119,121,1,3,124,167,1,0,2,2
2019-09-22,3,IND,ATL,Home,379,397,300,304,2,3,79,93,1,0,0,0
2019-09-29,4,IND,LVR,Away,346,377,265,189,3,2,81,188,0,1,2,2
2019-10-06,5,KAN,IND,Away,324,331,288,151,1,0,36,180,0,1,1,1
2019-10-20,7,IND,HOU,Home,383,391,321,291,4,1,62,100,0,1,1,1
2019-10-27,8,IND,DEN,Home,318,279,191,166,0,0,127,113,1,1,1,1
2019-11-03,9,PIT,IND,Home,273,328,183,189,1,3,90,139,0,0,3,3
2019-11-10,10,IND,MIA,Away,300,229,191,159,1,0,109,70,0,1,3,3
2019-11-17,11,IND,JAX,Home,389,308,125,279,1,2,264,29,3,0,2,2
2019-11-21,12,HOU,IND,Home,396,296,297,121,2,0,99,175,0,2,0,0
2019-12-01,13,IND,TEN,Away,391,292,309,138,1,2,82,154,1,1,3,3
2019-12-08,14,TAM,IND,Home,542,309,467,243,4,2,75,66,1,1,1,1
2019-12-16,15,NOR,IND,Home,424,205,307,159,4,0,117,46,0,1,0,0
2019-12-22,16,IND,CAR,Home,324,286,106,199,0,0,218,87,3,0,0,0
2019-12-29,17,JAX,IND,Home,353,275,286,143,3,0,67,132,0,2,2,2
2020-09-13,1,JAX,IND,Home,241,445,150,357,3,1,91,88,0,1,2,2
2020-09-20,2,IND,MIN,Home,354,175,203,95,1,0,151,80,1,1,1,1
2020-09-27,3,IND,NYJ,Home,353,260,234,151,1,1,119,109,1,0,0,0
2020-10-04,4,CHI,IND,Away,269,289,241,186,1,1,28,103,0,0,0,0
2020-10-11,5,CLE,IND,Home,385,308,261,240,2,0,124,68,0,1,2,2
2020-10-18,6,IND,CIN,Home,430,398,371,300,3,0,59,98,1,3,2,2
2020-11-01,8,DET,IND,Away,326,366,297,247,3,3,29,119,0,2,0,0
2020-11-08,9,IND,BAL,Away,339,266,227,156,0,0,112,110,1,2,2,2
2020-11-12,10,TEN,IND,Away,294,430,137,297,1,1,157,133,1,2,0,0
2020-11-22,11,IND,GNB,Home,420,367,280,301,3,3,140,66,0,1,2,2
2020-11-29,12,IND,TEN,Away,336,449,280,220,2,1,56,229,2,4,1,1
2020-12-06,13,HOU,IND,Away,398,371,308,262,0,2,90,109,2,1,0,0
2020-12-13,14,LVR,IND,Away,424,456,345,244,2,2,79,212,1,2,0,0
2020-12-20,15,IND,HOU,Home,350,425,223,342,2,2,127,83,1,0,0,0
2020-12-27,16,PIT,IND,Home,354,365,332,238,3,1,22,127,1,2,2,2
2021-01-03,17,IND,JAX,Home,437,283,164,230,1,2,273,53,2,0,1,1
2021-09-12,1,IND,SEA,Away,336,381,223,241,2,4,113,140,0,0,1,1
2021-09-19,2,IND,LAR,Away,354,371,245,270,1,2,109,101,0,1,2,2
2021-09-26,3,TEN,IND,Home,368,265,188,178,3,0,180,87,0,1,0,0
2021-10-03,4,MIA,IND,Away,203,349,168,210,2,2,35,139,0,1,1,1
2021-10-11,5,BAL,IND,Home,523,513,437,390,4,2,86,123,0,1,1,1
2021-10-17,6,IND,HOU,Home,388,353,214,229,2,0,174,124,2,0,0,0
2021-10-24,7,SFO,IND,Away,280,295,169,147,1,2,111,148,1,2,2,2
2021-10-31,8,IND,TEN,Away,307,340,224,247,3,3,83,93,1,0,3,3
2021-11-04,9,IND,NYJ,Home,532,486,272,398,3,4,260,88,3,0,0,0
2021-11-14,10,IND,JAX,Home,295,331,168,152,0,0,127,179,1,2,0,0
2021-11-21,11,BUF,IND,Away,311,370,220,106,2,1,91,264,0,4,0,0
2021-11-28,12,IND,TAM,Away,392,359,285,217,3,1,107,142,1,4,5,5
2021-12-05,13,HOU,IND,Away,141,389,57,151,0,1,84,238,0,3,1,1
2021-12-18,15,IND,NWE,Home,275,365,49,284,1,2,226,81,1,0,1,1
2021-12-25,16,ARI,IND,Away,378,346,245,220,1,2,133,126,1,0,0,0
2022-01-02,17,IND,LVR,Away,262,326,140,241,1,1,122,85,1,1,0,0
2022-01-09,18,JAX,IND,Home,318,233,217,139,2,1,101,94,0,0,2,2
2022-09-11,1,HOU,IND,Home,299,517,222,340,2,1,77,177,0,1,2,2
2022-09-18,2,JAX,IND,Home,331,218,235,164,2,0,96,54,1,0,3,3
2022-09-25,3,IND,KAN,Home,259,315,177,257,2,1,82,58,0,1,1,1
2022-10-02,4,IND,TEN,Away,365,243,327,116,2,2,38,127,0,1,3,3
2022-10-06,5,DEN,IND,Away,375,306,250,200,0,0,125,106,0,0,2,2
2022-10-16,6,IND,JAX,Home,434,379,389,136,3,1,45,243,1,3,0,0
2022-10-23,7,TEN,IND,Home,254,292,116,227,0,1,138,65,0,0,3,3
2022-10-30,8,IND,WAS,Away,324,362,189,266,0,1,135,96,1,1,2,2
2022-11-06,9,NWE,IND,Home,203,121,133,43,1,0,70,78,0,0,1,1
2022-11-13,10,LVR,IND,Away,309,415,232,208,2,1,77,207,1,2,1,1
2022-11-20,11,IND,PHI,Away,284,314,185,173,0,1,99,141,1,1,1,1
2022-11-28,12,IND,PIT,Away,290,323,180,151,1,0,110,172,1,2,2,2
2022-12-04,13,DAL,IND,Home,385,309,165,203,3,2,220,106,4,0,5,5
2022-12-17,15,MIN,IND,Home,518,341,426,170,4,1,92,171,1,0,1,1
2022-12-26,16,IND,LAC,Away,173,314,104,213,0,0,69,101,0,2,3,3
2023-01-01,17,NYG,IND,Home,394,252,177,124,2,1,217,128,2,0,1,1
2023-01-08,18,IND,HOU,Away,398,360,202,301,2,3,196,59,1,0,3,3
2023-09-10,1,IND,JAX,Away,280,342,215,237,1,2,65,105,1,2,3,3
2023-09-17,2,HOU,IND,Away,389,353,337,227,2,1,52,126,0,3,0,0
2023-09-24,3,BAL,IND,Away,364,327,178,188,0,1,186,139,2,0,0,0
2023-10-01,4,IND,LAR,Away,329,467,196,303,2,1,133,164,1,2,1,1
2023-10-08,5,IND,TEN,Home,429,348,236,259,0,0,193,89,2,1,0,0
2023-10-15,6,JAX,IND,Home,233,354,148,310,2,1,85,44,2,1,4,4
2023-10-22,7,IND,CLE,Away,456,316,288,166,2,0,168,150,3,3,4,4
2023-10-29,8,IND,NOR,Away,371,511,207,350,2,2,164,161,1,3,1,1
2023-11-05,9,CAR,IND,Away,275,198,137,120,1,1,138,78,0,0,1,1
2023-11-12,10,NWE,IND,Away,340,264,173,194,0,0,167,70,0,1,1,1
2023-11-26,12,IND,TAM,Home,394,298,239,173,0,2,155,125,3,0,1,1
2023-12-03,13,TEN,IND,Away,381,355,204,300,1,2,177,55,2,0,2,2
2023-12-10,14,CIN,IND,Home,385,272,274,226,2,1,111,46,2,0,2,2
2023-12-16,15,IND,PIT,Home,372,216,202,142,3,1,170,74,0,1,0,0
2023-12-24,16,ATL,IND,Home,406,262,229,170,1,0,177,92,1,1,1,1
2023-12-31,17,IND,LVR,Home,349,370,215,286,1,2,134,84,1,0,0,0
2024-01-06,18,IND,HOU,Away,360,306,133,246,0,2,227,60,1,1,1,1
2014-09-07,1,PHI,JAX,Home,420,306,275,242,2,2,145,64,1,0,1,1
2014-09-14,2,WAS,JAX,Home,449,148,258,123,2,1,191,25,3,0,1,1
2014-09-21,3,JAX,IND,Away,344,529,239,385,2,4,105,144,0,0,3,3
2014-09-28,4,LAC,JAX,Home,407,320,365,235,3,1,42,85,0,1,3,3
2014-10-05,5,JAX,PIT,Away,243,372,187,261,0,1,56,111,0,0,2,2
2014-10-12,6,TEN,JAX,Home,290,379,220,297,0,1,70,82,1,1,2,2
2014-10-19,7,JAX,CLE,Home,336,266,151,197,1,0,185,69,2,0,3,3
2014-10-26,8,JAX,MIA,Away,377,326,201,178,1,1,176,148,0,0,3,3
2014-11-02,9,CIN,JAX,Home,423,365,232,233,2,2,191,132,2,1,1,1
2014-11-09,10,JAX,DAL,Away,333,399,262,248,0,3,71,151,2,1,3,3
2014-11-23,12,IND,JAX,Home,389,194,214,114,1,0,175,80,1,0,2,2
2014-11-30,13,JAX,NYG,Home,258,329,140,213,1,1,118,116,0,2,0,0
2014-12-07,14,JAX,HOU,Away,262,304,188,135,1,0,74,169,0,3,1,1
2014-12-14,15,BAL,JAX,Home,314,248,221,166,1,0,93,82,0,0,1,1
2014-12-18,16,JAX,TEN,Home,288,357,111,262,1,1,177,95,2,0,0,0
2014-12-28,17,HOU,JAX,Home,358,233,235,112,2,1,123,121,1,0,0,0
2015-09-13,1,JAX,CAR,Away,265,263,169,158,1,1,96,105,0,0,3,3
2015-09-20,2,JAX,MIA,Home,396,386,273,344,2,2,123,42,0,0,0,0
2015-09-27,3,NWE,JAX,Home,471,293,346,236,2,2,125,57,4,0,1,1
2015-10-04,4,IND,JAX,Home,326,431,266,289,1,1,60,142,0,0,0,0
2015-10-11,5,TAM,JAX,Home,369,325,186,270,1,4,183,55,2,0,2,2
2015-10-18,6,JAX,HOU,Away,394,382,311,287,3,3,83,95,0,0,3,3
2015-10-25,7,JAX,BUF,Home,295,375,175,260,2,2,120,115,1,0,1,1
2015-11-08,9,NYJ,JAX,Home,290,436,261,338,2,2,29,98,2,0,4,4
2015-11-15,10,BAL,JAX,Away,397,258,308,168,3,2,89,90,0,0,1,1
2015-11-19,11,JAX,TEN,Home,308,316,218,212,1,0,90,104,0,1,2,2
2015-11-29,12,JAX,LAC,Away,420,369,318,290,2,4,102,79,0,0,1,1
2015-12-06,13,TEN,JAX,Home,467,383,257,302,3,5,210,81,2,1,1,1
2015-12-13,14,JAX,IND,Home,380,322,226,227,3,0,154,95,2,0,2,2
2015-12-20,15,JAX,ATL,Away,370,328,285,245,1,1,85,83,1,1,1,1
2015-12-27,16,NOR,JAX,Home,537,412,402,347,3,4,135,65,2,0,2,2
2016-01-03,17,HOU,JAX,Home,402,215,242,183,1,0,160,32,1,0,4,4
2016-09-11,1,JAX,GNB,Away,348,294,300,199,1,2,48,95,1,1,1,1
2016-09-18,2,LAC,JAX,Home,357,388,207,319,4,2,150,69,1,0,3,3
2016-09-25,3,JAX,BAL,Away,216,283,168,199,2,0,48,84,0,1,3,3
2016-10-02,4,JAX,IND,Home,331,284,195,190,2,2,136,94,1,1,0,0
2016-10-16,6,CHI,JAX,Away,389,317,297,263,0,1,92,54,1,1,2,2
2016-10-23,7,JAX,LVR,Away,344,344,239,200,1,1,105,144,0,2,3,3
2016-10-27,8,TEN,JAX,Home,494,370,280,322,2,3,214,48,2,0,1,1
2016-11-06,9,KAN,JAX,Home,231,449,169,244,1,2,62,205,0,0,4,4
2016-11-13,10,JAX,HOU,Away,327,273,247,92,2,2,80,181,0,0,2,2
2016-11-20,11,DET,JAX,Home,277,285,263,202,0,2,14,83,1,0,3,3
2016-11-27,12,BUF,JAX,Home,304,301,151,118,1,2,153,183,3,1,0,0
2016-12-04,13,JAX,DEN,Away,333,206,179,102,0,0,154,104,1,1,3,3
2016-12-11,14,JAX,MIN,Away,315,377,230,292,1,1,85,85,0,1,0,0
2016-12-18,15,HOU,JAX,Home,387,150,308,83,0,0,79,67,1,1,1,1
2016-12-24,16,JAX,TEN,Home,415,263,331,205,2,2,84,58,1,0,1,1
2017-01-01,17,IND,JAX,Home,384,470,290,288,2,1,94,182,1,1,2,2
2017-09-10,1,HOU,JAX,Away,203,280,110,125,1,1,93,155,0,1,0,0
2017-09-17,2,JAX,TEN,Away,310,390,211,211,1,1,99,179,1,3,3,3
2017-09-24,3,JAX,BAL,Home,410,186,244,52,4,1,166,134,1,0,0,0
2017-10-01,4,NYJ,JAX,Home,471,311,215,136,0,1,256,175,2,0,1,1
2017-10-08,5,PIT,JAX,Away,371,313,301,82,0,0,70,231,0,2,1,1
2017-10-15,6,JAX,LAR,Away,389,249,220,107,1,1,169,142,1,0,1,1
2017-10-22,7,IND,JAX,Away,232,518,136,330,0,1,96,188,0,2,2,2
2017-11-05,9,JAX,CIN,Home,408,148,259,119,1,0,149,29,0,1,1,1
2017-11-12,10,JAX,LAC,Home,398,322,263,235,1,2,135,87,1,0,2,2
2017-11-19,11,CLE,JAX,Away,184,284,134,145,1,1,50,139,0,0,1,1
2017-11-26,12,ARI,JAX,Home,344,219,236,128,2,0,108,91,0,2,3,3
2017-12-03,13,JAX,IND,Home,426,290,330,149,2,1,96,141,1,0,0,0
2017-12-10,14,JAX,SEA,Home,424,401,268,260,2,3,156,141,1,0,1,1
2017-12-17,15,JAX,HOU,Home,464,186,326,99,3,1,138,87,3,0,0,0
2017-12-24,16,SFO,JAX,Home,369,472,238,380,2,2,131,92,3,2,3,3
2017-12-31,17,TEN,JAX,Home,232,229,116,146,1,0,116,83,0,0,4,4
2018-09-09,1,NYG,JAX,Away,324,305,210,168,0,1,114,137,1,0,1,1
2018-09-16,2,JAX,NWE,Home,480,302,376,220,4,2,104,82,0,0,2,2
2018-09-23,3,JAX,TEN,Away,232,233,145,83,0,0,87,150,0,0,1,1
2018-09-30,4,JAX,NYJ,Home,503,178,377,144,2,1,126,34,1,0,3,3
2018-10-07,5,KAN,JAX,Home,424,502,298,401,0,1,126,101,2,1,5,5
2018-10-14,6,DAL,JAX,Home,378,204,172,139,2,1,206,65,2,0,2,2
2018-10-21,7,JAX,HOU,Away,259,272,189,131,1,1,70,141,0,1,3,3
2018-10-28,8,JAX,PHI,Away,335,395,265,262,1,3,70,133,0,0,1,1
2018-11-11,10,IND,JAX,Home,366,415,285,324,3,2,81,91,1,1,1,1
2018-11-18,11,JAX,PIT,Away,243,323,64,297,0,2,179,26,1,1,1,1
2018-11-25,12,BUF,JAX,Home,327,333,160,107,1,1,167,226,2,2,2,2
2018-12-02,13,JAX,IND,Home,211,265,132,224,0,0,79,41,0,0,1,1
2018-12-06,14,TEN,JAX,Home,426,255,162,195,0,1,264,60,4,0,1,1
2018-12-16,15,JAX,WAS,Away,192,245,20,136,0,1,172,109,0,0,2,2
2018-12-23,16,MIA,JAX,Away,183,244,121,118,1,0,62,126,0,1,1,1
2018-12-30,17,HOU,JAX,Home,342,119,208,89,0,0,134,30,2,0,2,2
2019-09-08,1,JAX,KAN,Away,428,491,347,378,3,3,81,113,0,1,2,2
2019-09-15,2,HOU,JAX,Home,263,281,137,178,0,1,126,103,1,0,1,1
2019-09-19,3,JAX,TEN,Home,292,340,204,249,2,0,88,91,0,1,0,0
2019-09-29,4,DEN,JAX,Away,371,455,303,186,3,2,68,269,0,0,0,0
2019-10-06,5,CAR,JAX,Home,445,507,160,358,1,2,285,149,3,1,3,3
2019-10-13,6,JAX,NOR,Away,226,326,151,222,0,1,75,104,0,0,1,1
2019-10-20,7,CIN,JAX,Away,291,460,258,244,1,1,33,216,1,0,0,0
2019-10-27,8,JAX,NYJ,Home,389,213,278,167,3,2,111,46,0,0,1,1
2019-11-03,9,JAX,HOU,Away,356,410,282,194,0,2,74,216,0,1,4,4
2019-11-17,11,IND,JAX,Home,389,308,125,279,1,2,264,29,3,0,1,1
2019-11-24,12,TEN,JAX,Home,471,369,252,252,2,0,219,117,4,2,1,1
2019-12-01,13,JAX,TAM,Away,242,315,193,241,1,0,49,74,0,2,4,4
2019-12-08,14,JAX,LAC,Away,252,525,164,330,1,4,88,195,0,2,0,0
2019-12-15,15,LVR,JAX,Away,364,262,236,185,1,2,128,77,0,0,0,0
2019-12-22,16,ATL,JAX,Home,518,288,383,173,1,1,135,115,2,0,1,1
2019-12-29,17,JAX,IND,Home,353,275,286,143,3,0,67,132,0,2,1,1
2020-09-13,1,JAX,IND,Home,241,445,150,357,3,1,91,88,0,1,0,0
2020-09-20,2,TEN,JAX,Home,354,480,231,315,4,3,123,165,0,1,2,2
2020-09-24,3,JAX,MIA,Away,318,294,246,156,0,2,72,138,2,2,2,2
2020-10-04,4,CIN,JAX,Home,505,429,300,340,1,2,205,89,2,0,1,1
2020-10-11,5,HOU,JAX,Home,486,364,357,289,3,2,129,75,0,0,2,2
2020-10-18,6,JAX,DET,Away,275,403,231,223,1,1,44,180,1,3,2,2
2020-10-25,7,LAC,JAX,Home,484,294,349,154,3,2,135,140,2,1,1,1
2020-11-08,9,JAX,HOU,Away,403,374,288,267,1,2,115,107,2,1,1,1
2020-11-15,10,GNB,JAX,Home,395,260,315,151,2,1,80,109,1,0,1,1
2020-11-22,11,JAX,PIT,Away,206,373,133,267,0,2,73,106,0,1,4,4
2020-11-29,12,JAX,CLE,Away,375,459,235,252,2,2,140,207,1,1,0,0
2020-12-06,13,MIN,JAX,Home,420,390,275,266,3,1,145,124,0,1,4,4
2020-12-13,14,JAX,TEN,Away,354,454,263,205,1,2,91,249,0,2,1,1
2020-12-20,15,BAL,JAX,Home,409,267,250,205,3,2,159,62,2,0,1,1
2020-12-27,16,JAX,CHI,Away,279,391,203,263,2,2,76,128,0,3,2,2
2021-01-03,17,IND,JAX,Home,437,283,164,230,1,2,273,53,2,0,1,1
2021-09-12,1,HOU,JAX,Home,449,395,289,319,2,3,160,76,2,0,3,3
2021-09-19,2,JAX,DEN,Away,189,398,114,302,1,2,75,96,0,0,2,2
2021-09-26,3,JAX,ARI,Away,361,407,202,316,1,0,159,91,1,3,4,4
2021-09-30,4,CIN,JAX,Home,420,341,342,202,2,0,78,139,1,3,0,0
2021-10-10,5,JAX,TEN,Away,454,368,256,184,1,1,198,184,2,3,2,2
2021-10-17,6,JAX,MIA,Home,396,431,312,354,1,2,84,77,1,0,1,1
2021-10-31,8,SEA,JAX,Home,229,309,160,227,2,1,69,82,1,0,1,1
2021-11-07,9,JAX,BUF,Home,218,301,139,229,0,0,79,72,0,0,1,1
2021-11-14,10,IND,JAX,Home,295,331,168,152,0,0,127,179,1,2,1,1
2021-11-21,11,JAX,SFO,Away,200,333,146,162,0,2,54,171,1,1,2,2
2021-11-28,12,JAX,ATL,Away,357,332,216,183,1,1,141,149,0,2,2,2
2021-12-05,13,LAR,JAX,Home,418,197,290,136,3,0,128,61,1,1,2,2
2021-12-12,14,TEN,JAX,Home,263,192,161,184,0,0,102,8,2,0,4,4
2021-12-19,15,JAX,HOU,Away,296,281,189,206,0,2,107,75,1,0,0,0
2021-12-26,16,NYJ,JAX,Home,373,384,100,252,1,0,273,132,1,1,1,1
2022-01-02,17,NWE,JAX,Home,471,253,290,173,3,1,181,80,4,0,3,3
2022-01-09,18,JAX,IND,Home,318,233,217,139,2,1,101,94,0,0,0,0
2022-09-11,1,WAS,JAX,Home,390,383,305,260,4,1,85,123,0,1,1,1
2022-09-18,2,JAX,IND,Home,331,218,235,164,2,0,96,54,1,0,0,0
2022-09-25,3,LAC,JAX,Away,312,413,286,262,1,3,26,151,0,1,0,0
2022-10-02,4,PHI,JAX,Home,401,219,191,148,0,2,210,71,4,0,5,5
2022-10-09,5,JAX,HOU,Away,422,248,286,132,0,0,136,116,0,1,2,2
2022-10-16,6,IND,JAX,Home,434,379,389,136,3,1,45,243,1,3,1,1
2022-10-23,7,JAX,NYG,Away,452,436,310,200,0,1,142,236,2,1,1,1
2022-10-30,8,JAX,DEN,Away,305,331,114,230,1,1,191,101,1,2,2,2
2022-11-06,9,JAX,LVR,Home,403,321,235,248,1,2,168,73,2,0,1,1
2022-11-13,10,KAN,JAX,Home,486,315,331,240,4,2,155,75,0,0,0,0
2022-11-27,12,JAX,BAL,Home,332,415,294,253,3,1,38,162,0,1,1,1
2022-12-04,13,DET,JAX,Home,437,266,337,171,2,1,100,95,2,0,1,1
2022-12-11,14,TEN,JAX,Away,364,428,227,368,2,3,137,60,1,1,0,0
2022-12-18,15,JAX,DAL,Home,503,397,311,243,4,3,192,154,0,1,3,3
2022-12-22,16,NYJ,JAX,Away,227,365,161,218,0,0,66,147,0,1,1,1
2023-01-01,17,HOU,JAX,Away,277,337,193,168,0,0,84,169,0,3,2,2
2023-01-07,18,JAX,TEN,Home,222,312,203,165,1,1,19,147,0,0,1,1
2023-09-10,1,IND,JAX,Away,280,342,215,237,1,2,65,105,1,2,2,2
2023-09-17,2,JAX,KAN,Away,271,399,197,298,0,2,74,101,0,0,1,1
2023-09-24,3,JAX,HOU,Away,404,366,288,280,1,2,116,86,1,1,2,2
2023-10-01,4,JAX,ATL,Home,300,287,195,160,1,1,105,127,0,0,0,0
2023-10-08,5,BUF,JAX,Away,388,474,359,278,2,1,29,196,1,2,2,2
2023-10-15,6,JAX,IND,Home,233,354,148,310,2,1,85,44,2,1,1,1
2023-10-19,7,NOR,JAX,Away,407,330,295,217,1,1,112,113,1,2,2,2
2023-10-29,8,PIT,JAX,Away,261,377,191,271,1,1,70,106,0,0,3,3
2023-11-12,10,JAX,SFO,Away,221,437,162,293,0,3,59,144,0,1,4,4
2023-11-19,11,JAX,TEN,Home,389,235,261,143,2,2,128,92,2,0,0,0
2023-11-26,12,HOU,JAX,Away,352,445,261,364,2,1,91,81,1,1,1,1
2023-12-04,13,JAX,CIN,Away,376,491,305,335,2,1,71,156,2,3,0,0
2023-12-10,14,CLE,JAX,Home,389,293,307,235,3,3,82,58,1,1,4,4
2023-12-17,15,JAX,BAL,Away,333,396,258,145,1,1,75,251,0,1,2,2
2023-12-24,16,TAM,JAX,Home,335,305,265,268,2,2,70,37,1,0,4,4
2023-12-31,17,JAX,CAR,Home,317,124,162,67,0,0,155,57,2,0,0,0
2024-01-07,18,TEN,JAX,Home,327,362,152,280,2,2,175,82,2,0,2,2
2014-09-07,1,KAN,TEN,Away,245,405,178,243,1,2,67,162,0,0,3,3
2014-09-14,2,DEN,KAN,Home,325,380,237,247,3,0,88,133,0,2,0,0
2014-09-21,3,MIA,KAN,Away,332,342,191,168,1,3,141,174,0,2,2,2
2014-09-29,4,KAN,NWE,Home,443,290,236,215,3,2,207,75,1,0,0,0
2014-10-05,5,SFO,KAN,Home,357,265,186,158,1,1,171,107,0,1,1,1
2014-10-19,7,LAC,KAN,Away,251,365,182,211,2,1,69,154,0,1,0,0
2014-10-26,8,KAN,LAR,Home,355,200,215,116,0,1,140,84,3,0,1,1
2014-11-02,9,KAN,NYJ,Home,309,364,196,225,2,1,113,139,1,0,0,0
2014-11-09,10,BUF,KAN,Away,364,278,253,151,1,0,111,127,0,2,1,1
2014-11-16,11,KAN,SEA,Home,298,372,108,168,0,2,190,204,3,0,2,2
2014-11-20,12,LVR,KAN,Home,351,313,172,217,1,2,179,96,2,0,0,0
2014-11-30,13,KAN,DEN,Away,151,388,110,174,2,2,41,214,0,0,3,3
2014-12-07,14,ARI,KAN,Home,366,390,225,264,1,1,141,126,0,1,2,2
2014-12-14,15,KAN,LVR,Home,388,280,295,202,2,1,93,78,1,0,1,1
2014-12-21,16,PIT,KAN,Home,282,327,214,288,1,0,68,39,1,0,1,1
2014-12-28,17,KAN,LAC,Home,251,361,140,249,0,0,111,112,0,1,0,0
2015-09-13,1,HOU,KAN,Away,396,330,298,233,2,3,98,97,0,0,0,0
2015-09-17,2,KAN,DEN,Away,314,299,167,238,0,3,147,61,2,0,5,5
2015-09-28,3,GNB,KAN,Home,448,326,325,251,5,1,123,75,0,3,1,1
2015-10-04,4,CIN,KAN,Home,445,461,321,348,1,0,124,113,4,0,1,1
2015-10-11,5,KAN,CHI,Away,287,328,170,241,1,2,117,87,0,0,0,0
2015-10-18,6,MIN,KAN,Home,321,328,237,271,1,1,84,57,0,0,1,1
2015-10-25,7,KAN,PIT,Home,377,339,239,192,1,1,138,147,1,0,0,0
2015-11-01,8,KAN,DET,Home,340,276,134,195,2,1,206,81,4,0,0,0
2015-11-15,10,DEN,KAN,Away,221,303,152,197,1,1,69,106,1,1,0,0
2015-11-22,11,LAC,KAN,Away,201,385,149,232,0,0,52,153,0,3,0,0
2015-11-29,12,KAN,BUF,Home,413,415,255,286,2,3,158,129,1,0,0,0
2015-12-06,13,LVR,KAN,Away,361,232,262,143,2,2,99,89,1,2,2,2
2015-12-13,14,KAN,LAC,Home,329,280,179,236,1,0,150,44,0,0,2,2
2015-12-20,15,BAL,KAN,Away,366,277,273,164,2,1,93,113,0,1,0,0
2015-12-27,16,KAN,CLE,Home,258,368,122,136,2,0,136,232,0,1,1,1
2016-01-03,17,KAN,LVR,Home,339,205,150,157,2,1,189,48,1,0,2,2
2016-09-11,1,KAN,LAC,Home,413,388,330,233,2,1,83,155,2,2,1,1
2016-09-18,2,HOU,KAN,Home,351,291,254,172,1,0,97,119,0,0,3,3
2016-09-25,3,KAN,NYJ,Home,293,305,221,188,1,0,72,117,0,0,1,1
2016-10-02,4,PIT,KAN,Home,436,357,287,270,5,2,149,87,1,0,2,2
2016-10-16,6,LVR,KAN,Away,285,406,221,223,1,0,64,183,0,3,0,0
2016-10-23,7,KAN,NOR,Home,326,463,214,359,2,3,112,104,0,0,0,0
2016-10-30,8,IND,KAN,Away,277,422,172,334,2,3,105,88,0,0,0,0
2016-11-06,9,KAN,JAX,Home,231,449,169,244,1,2,62,205,0,0,0,0
2016-11-13,10,CAR,KAN,Away,341,256,242,165,1,0,99,91,1,0,1,1
2016-11-20,11,KAN,TAM,Away,343,442,261,326,1,1,82,116,1,0,2,2
2016-11-27,12,DEN,KAN,Away,464,273,340,190,3,1,124,83,0,1,0,0
2016-12-04,13,ATL,KAN,Away,418,389,290,266,1,1,128,123,2,2,1,1
2016-12-08,14,KAN,LVR,Home,323,244,258,109,1,0,65,135,1,1,3,3
2016-12-18,15,KAN,TEN,Away,316,389,159,241,0,0,157,148,2,2,1,1
2016-12-25,16,KAN,DEN,Home,484,246,246,183,2,0,238,63,2,1,1,1
2017-01-01,17,LAC,KAN,Away,398,365,269,262,2,2,129,103,0,1,1,1
2017-09-07,1,NWE,KAN,Away,371,537,247,352,0,4,124,185,3,2,1,1
2017-09-17,2,KAN,PHI,Home,344,406,232,299,1,2,112,107,2,0,0,0
2017-09-24,3,LAC,KAN,Away,330,311,226,122,0,2,104,189,1,1,0,0
2017-10-02,4,KAN,WAS,Home,429,331,261,220,1,2,168,111,1,0,0,0
2017-10-08,5,HOU,KAN,Away,392,450,248,323,5,3,144,127,0,0,0,0
2017-10-15,6,KAN,PIT,Away,251,439,223,245,1,1,28,194,0,1,0,0
2017-10-19,7,LVR,KAN,Home,505,425,417,331,3,3,88,94,1,0,0,0
2017-10-30,8,KAN,DEN,Home,276,364,197,187,1,1,79,177,0,1,2,2
2017-11-05,9,DAL,KAN,Home,375,323,244,255,2,2,131,68,2,0,1,1
2017-11-19,11,NYG,KAN,Home,317,363,205,229,0,0,112,134,1,0,3,3
2017-11-26,12,KAN,BUF,Away,236,268,181,164,1,1,55,104,0,0,1,1
2017-12-03,13,NYJ,KAN,Home,488,474,331,362,1,4,157,112,3,0,0,0
2017-12-10,14,KAN,LVR,Home,408,268,243,198,0,1,165,70,2,1,1,1
2017-12-16,15,KAN,LAC,Home,397,307,223,209,2,1,174,98,1,1,0,0
2017-12-24,16,KAN,MIA,Home,404,345,301,286,1,1,103,59,1,0,0,0
2017-12-31,17,DEN,KAN,Away,336,379,226,269,2,0,110,110,0,2,2,2
2018-09-09,1,LAC,KAN,Away,541,362,418,256,3,4,123,106,0,0,0,0
2018-09-16,2,PIT,KAN,Away,475,449,442,322,3,6,33,127,2,0,1,1
2018-09-23,3,KAN,SFO,Home,384,406,307,228,3,2,77,178,2,1,0,0
2018-10-01,4,DEN,KAN,Away,385,446,226,304,0,1,159,142,2,2,0,0
2018-10-07,5,KAN,JAX,Home,424,502,298,401,0,1,126,101,2,1,2,2
2018-10-14,6,NWE,KAN,Home,500,446,327,352,1,4,173,94,3,0,2,2
2018-10-21,7,KAN,CIN,Home,551,239,353,174,4,1,198,65,1,0,1,1
2018-10-28,8,KAN,DEN,Home,340,411,291,222,4,2,49,189,0,1,1,1
2018-11-04,9,CLE,KAN,Away,388,499,286,360,2,3,102,139,1,2,1,1
2018-11-11,10,KAN,ARI,Home,330,260,212,166,2,1,118,94,1,1,0,0
2018-11-19,11,LAR,KAN,Home,455,546,379,448,4,6,76,98,1,0,5,5
2018-12-02,13,LVR,KAN,Away,442,469,271,295,3,4,171,174,1,1,1,1
2018-12-09,14,KAN,BAL,Home,442,321,348,127,2,2,94,194,1,1,1,1
2018-12-13,15,KAN,LAC,Away,294,407,234,288,2,2,60,119,2,2,0,0
2018-12-23,16,SEA,KAN,Home,464,419,254,265,3,3,210,154,2,0,2,2
2018-12-30,17,KAN,LVR,Home,409,292,310,165,2,0,99,127,2,0,1,1
2019-09-08,1,JAX,KAN,Away,428,491,347,378,3,3,81,113,0,1,0,0
2019-09-15,2,LVR,KAN,Away,307,467,178,436,1,4,129,31,0,0,1,1
2019-09-22,3,KAN,BAL,Home,503,452,363,249,3,0,140,203,1,4,0,0
2019-09-29,4,DET,KAN,Away,447,438,261,315,3,0,186,123,0,3,3,3
2019-10-06,5,KAN,IND,Away,324,331,288,151,1,0,36,180,0,1,1,1
2019-10-13,6,KAN,HOU,Away,309,472,256,280,3,1,53,192,0,3,2,2
2019-10-17,7,DEN,KAN,Away,205,271,134,191,0,2,71,80,1,0,0,0
2019-10-27,8,KAN,GNB,Away,337,374,249,256,2,3,88,118,1,1,1,1
2019-11-03,9,KAN,MIN,Home,377,308,230,212,1,3,147,96,1,0,1,1
2019-11-10,10,TEN,KAN,Home,371,530,146,433,2,3,225,97,2,0,1,1
2019-11-18,11,LAC,KAN,Away,438,310,345,180,1,1,93,130,0,2,1,1
2019-12-01,13,KAN,LVR,Home,259,332,163,210,1,1,96,122,3,0,0,0
2019-12-08,14,NWE,KAN,Away,278,346,184,271,1,1,94,75,1,1,2,2
2019-12-15,15,KAN,DEN,Home,419,251,327,199,2,0,92,52,0,0,1,1
2019-12-22,16,CHI,KAN,Away,234,350,133,244,0,2,101,106,0,1,0,0
2019-12-29,17,KAN,LAC,Home,336,366,174,258,1,2,162,108,2,1,1,1
2020-09-10,1,KAN,HOU,Home,369,360,203,242,3,1,166,118,1,2,0,0
2020-09-20,2,LAC,KAN,Away,479,414,296,289,1,2,183,125,1,0,0,0
2020-09-28,3,BAL,KAN,Away,228,517,70,385,1,4,158,132,0,1,1,1
2020-10-05,4,KAN,NWE,Home,323,357,229,172,2,1,94,185,0,0,1,1
2020-10-11,5,KAN,LVR,Away,413,490,333,346,2,3,80,144,2,2,1,1
2020-10-19,6,BUF,KAN,Away,206,466,122,221,2,2,84,245,0,1,1,1
2020-10-25,7,DEN,KAN,Away,411,286,234,185,0,1,177,101,2,2,1,1
2020-11-01,8,KAN,NYJ,Home,496,221,446,128,5,0,50,93,0,0,0,0
2020-11-08,9,KAN,CAR,Home,397,435,361,331,4,2,36,104,0,2,1,1
2020-11-22,11,LVR,KAN,Away,364,460,275,352,3,2,89,108,1,3,1,1
2020-11-29,12,TAM,KAN,Away,417,543,342,456,3,3,75,87,0,0,1,1
2020-12-06,13,KAN,DEN,Home,447,330,313,151,1,2,134,179,0,0,0,0
2020-12-13,14,MIA,KAN,Away,367,448,287,354,2,2,80,94,1,1,4,4
2020-12-20,15,NOR,KAN,Away,285,411,225,232,3,3,60,179,1,1,1,1
2020-12-27,16,KAN,ATL,Home,395,367,278,277,2,2,117,90,0,0,2,2
2021-01-03,17,KAN,LAC,Away,268,416,217,281,2,3,51,135,1,2,1,1
2021-09-12,1,KAN,CLE,Home,397,457,324,304,3,0,73,153,1,4,0,0
2021-09-19,2,BAL,KAN,Home,481,405,230,343,1,3,251,62,3,1,2,2
2021-09-26,3,KAN,LAC,Away,437,352,251,275,3,4,186,77,0,0,4,4
2021-10-03,4,PHI,KAN,Away,461,471,358,271,2,5,103,200,1,1,1,1
2021-10-10,5,KAN,BUF,Away,392,436,272,315,2,3,120,121,0,1,4,4
2021-10-17,6,WAS,KAN,Away,276,499,182,390,1,2,94,109,0,2,3,3
2021-10-24,7,TEN,KAN,Home,369,334,266,257,2,0,103,77,1,0,3,3
2021-11-01,8,KAN,NYG,Home,368,300,261,228,1,2,107,72,1,0,2,2
2021-11-07,9,KAN,GNB,Home,237,301,160,179,1,1,77,122,0,0,0,0
2021-11-14,10,LVR,KAN,Away,299,516,249,422,2,5,50,94,0,0,1,1
2021-11-21,11,KAN,DAL,Home,370,276,244,194,0,0,126,82,2,0,2,2
2021-12-05,13,KAN,DEN,Home,267,404,178,250,0,1,89,154,1,0,1,1
2021-12-12,14,KAN,LVR,Home,372,290,240,246,2,1,132,44,3,0,0,0
2021-12-16,15,LAC,KAN,Away,428,496,236,410,2,3,192,86,2,1,2,2
2021-12-26,16,KAN,PIT,Home,381,303,254,173,3,1,127,130,1,0,0,0
2022-01-02,17,CIN,KAN,Home,475,414,415,259,4,2,60,155,0,2,0,0
2022-01-08,18,DEN,KAN,Away,364,390,173,255,0,2,191,135,3,0,0,0
2022-09-11,1,ARI,KAN,Away,282,488,179,360,2,5,103,128,1,1,1,1
2022-09-15,2,KAN,LAC,Home,319,401,226,326,2,3,93,75,0,0,0,0
2022-09-25,3,IND,KAN,Home,259,315,177,257,2,1,82,58,0,1,2,2
2022-10-02,4,TAM,KAN,Away,376,417,373,228,3,3,3,189,1,2,1,1
2022-10-10,5,KAN,LVR,Home,368,378,265,223,4,2,103,155,0,1,0,0
2022-10-16,6,KAN,BUF,Away,387,443,319,318,2,3,68,125,0,0,2,2
2022-10-23,7,SFO,KAN,Away,444,529,343,417,2,3,101,112,0,3,2,2
2022-11-06,9,KAN,TEN,Home,499,229,422,57,1,0,77,172,1,2,1,1
2022-11-13,10,KAN,JAX,Home,486,315,331,240,4,2,155,75,0,0,3,3
2022-11-20,11,LAC,KAN,Away,365,485,250,322,2,3,115,163,1,0,1,1
2022-11-27,12,KAN,LAR,Home,437,198,320,82,1,1,117,116,1,0,2,2
2022-12-04,13,CIN,KAN,Home,431,349,279,211,2,1,152,138,1,2,1,1
2022-12-11,14,DEN,KAN,Away,320,431,214,342,4,3,106,89,0,0,3,3
2022-12-18,15,HOU,KAN,Away,219,502,125,313,2,2,94,189,1,2,2,2
2022-12-24,16,KAN,SEA,Home,297,333,220,200,2,1,77,133,1,0,0,0
2023-01-01,17,KAN,DEN,Home,374,307,328,190,3,1,46,117,1,2,2,2
2023-01-07,18,LVR,KAN,Away,279,349,180,181,1,1,99,168,0,3,0,0
2023-09-07,1,KAN,DET,Away,316,368,226,250,2,1,90,118,0,1,1,1
2023-09-17,2,JAX,KAN,Away,271,399,197,298,0,2,74,101,0,0,3,3
2023-09-24,3,KAN,CHI,Home,456,203,303,87,3,1,153,116,2,0,2,2
2023-10-01,4,NYJ,KAN,Away,336,401,228,197,2,1,108,204,0,1,2,2
2023-10-08,5,MIN,KAN,Away,329,333,259,266,2,2,70,67,0,1,0,0
2023-10-12,6,KAN,DEN,Home,389,197,293,82,1,1,96,115,0,0,1,1
2023-10-22,7,KAN,LAC,Home,483,358,415,219,4,1,68,139,0,1,2,2
2023-10-29,8,DEN,KAN,Home,240,274,87,212,3,0,153,62,0,0,5,5
2023-11-05,9,KAN,MIA,Home,267,292,174,175,2,1,93,117,0,1,1,1
2023-11-20,11,KAN,PHI,Away,336,238,168,124,2,0,168,114,0,3,2,2
2023-11-26,12,LVR,KAN,Away,358,360,235,291,1,2,123,69,1,2,0,0
2023-12-03,13,GNB,KAN,Home,382,337,253,189,3,1,129,148,0,1,1,1
2023-12-10,14,KAN,BUF,Away,346,327,264,209,1,1,82,118,1,1,2,2
2023-12-17,15,NWE,KAN,Away,206,326,154,283,1,3,52,43,1,0,2,2
2023-12-25,16,KAN,LVR,Away,308,205,223,48,1,0,85,157,1,0,2,2
2023-12-31,17,KAN,CIN,Home,373,263,241,159,1,1,132,104,0,1,1,1
2024-01-07,18,LAC,KAN,Away,353,268,235,145,0,0,118,123,0,0,1,1
2014-09-08,1,ARI,LAC,Home,403,290,294,238,2,1,109,52,0,1,1,1
2014-09-14,2,LAC,SEA,Home,377,288,276,180,3,2,101,108,0,1,0,0
2014-09-21,3,BUF,LAC,Away,292,333,205,250,1,2,87,83,0,0,0,0
2014-09-28,4,LAC,JAX,Home,407,320,365,235,3,1,42,85,0,1,0,0
2014-10-05,5,LAC,NYJ,Home,439,151,277,60,3,0,162,91,1,0,1,1
2014-10-12,6,LVR,LAC,Away,396,423,282,307,4,3,114,116,0,1,0,0
2014-10-19,7,LAC,KAN,Away,251,365,182,211,2,1,69,154,0,1,1,1
2014-10-23,8,DEN,LAC,Home,425,306,286,245,3,3,139,61,2,0,2,2
2014-11-02,9,MIA,LAC,Home,441,178,309,128,3,0,132,50,1,0,4,4
2014-11-16,11,LAC,LVR,Home,300,233,180,162,1,0,120,71,0,0,0,0
2014-11-23,12,LAC,LAR,Home,410,317,282,210,1,1,128,107,1,1,3,3
2014-11-30,13,BAL,LAC,Away,350,440,225,376,2,3,125,64,1,1,2,2
2014-12-07,14,LAC,NWE,Away,216,397,163,310,1,2,53,87,0,0,1,1
2014-12-14,15,LAC,DEN,Away,288,337,232,226,1,1,56,111,0,0,2,2
2014-12-20,16,SFO,LAC,Away,447,446,92,348,1,4,355,98,3,0,3,3
2014-12-28,17,KAN,LAC,Home,251,361,140,249,0,0,111,112,0,1,3,3
2015-09-13,1,LAC,DET,Home,483,302,387,233,2,2,96,69,2,1,3,3
2015-09-20,2,CIN,LAC,Home,389,354,214,223,3,2,175,131,0,0,3,3
2015-09-27,3,MIN,LAC,Home,284,369,121,279,0,2,163,90,3,0,2,2
2015-10-04,4,LAC,CLE,Home,438,432,347,332,3,2,91,100,0,0,0,0
2015-10-12,5,LAC,PIT,Away,406,349,354,194,2,1,52,155,0,1,2,2
2015-10-18,6,GNB,LAC,Home,370,548,237,488,2,2,133,60,1,0,1,1
2015-10-25,7,LAC,LVR,Away,417,412,327,282,3,3,90,130,0,1,2,2
2015-11-01,8,BAL,LAC,Home,365,371,293,290,1,3,72,81,1,0,0,0
2015-11-09,9,LAC,CHI,Away,339,446,262,337,1,2,77,109,0,1,1,1
2015-11-22,11,LAC,KAN,Away,201,385,149,232,0,0,52,153,0,3,2,2
2015-11-29,12,JAX,LAC,Away,420,369,318,290,2,4,102,79,0,0,0,0
2015-12-06,13,LAC,DEN,Away,272,293,179,159,0,1,93,134,0,0,3,3
2015-12-13,14,KAN,LAC,Home,329,280,179,236,1,0,150,44,0,0,1,1
2015-12-20,15,LAC,MIA,Home,442,231,302,187,3,0,140,44,1,2,2,2
2015-12-24,16,LVR,LAC,Home,281,343,175,271,1,1,106,72,1,1,1,1
2016-01-03,17,DEN,LAC,Home,503,317,293,207,1,2,210,110,2,0,1,1
2016-09-11,1,KAN,LAC,Home,413,388,330,233,2,1,83,155,2,2,0,0
2016-09-18,2,LAC,JAX,Home,357,388,207,319,4,2,150,69,1,0,1,1
2016-09-25,3,IND,LAC,Home,410,352,317,315,1,0,93,37,2,1,3,3
2016-10-02,4,LAC,NOR,Away,346,275,308,192,2,2,38,83,2,3,3,3
2016-10-09,5,LVR,LAC,Home,389,423,300,351,2,4,89,72,1,0,4,4
2016-10-13,6,LAC,DEN,Home,265,304,166,220,1,1,99,84,0,0,2,2
2016-10-23,7,ATL,LAC,Away,386,426,256,348,1,1,130,78,1,2,2,2
2016-10-30,8,DEN,LAC,Home,324,369,267,246,0,2,57,123,2,0,3,3
2016-11-06,9,LAC,TEN,Home,476,393,268,313,2,3,208,80,1,2,0,0
2016-11-13,10,LAC,MIA,Away,379,337,309,231,3,2,70,106,0,1,4,4
2016-11-27,12,HOU,LAC,Away,353,302,239,235,0,3,114,67,1,0,1,1
2016-12-04,13,LAC,TAM,Away,330,349,211,268,2,1,119,81,1,1,2,2
2016-12-11,14,CAR,LAC,Home,272,278,146,220,1,2,126,58,1,0,5,5
2016-12-18,15,LAC,LVR,Away,263,345,190,200,2,1,73,145,0,0,2,2
2016-12-24,16,CLE,LAC,Home,251,356,127,322,0,2,124,34,2,0,1,1
2017-01-01,17,LAC,KAN,Away,398,365,269,262,2,2,129,103,0,1,2,2
2017-09-11,1,DEN,LAC,Home,321,249,181,185,2,3,140,64,1,0,1,1
2017-09-17,2,LAC,MIA,Away,367,336,323,225,1,1,44,111,1,0,0,0
2017-09-24,3,LAC,KAN,Away,330,311,226,122,0,2,104,189,1,1,3,3
2017-10-01,4,LAC,PHI,Away,400,454,342,240,2,1,58,214,1,1,1,1
2017-10-08,5,NYG,LAC,Away,335,382,183,258,2,3,152,124,1,0,1,1
2017-10-15,6,LVR,LAC,Away,274,343,165,263,1,1,109,80,1,1,1,1
2017-10-22,7,LAC,DEN,Home,242,251,162,182,2,0,80,69,0,0,0,0
2017-10-29,8,NWE,LAC,Home,414,349,317,192,1,1,97,157,0,1,1,1
2017-11-12,10,JAX,LAC,Home,398,322,263,235,1,2,135,87,1,0,2,2
2017-11-19,11,LAC,BUF,Home,429,393,283,220,2,1,146,173,2,2,0,0
2017-11-23,12,DAL,LAC,Away,247,515,168,434,0,3,79,81,1,0,0,0
2017-12-03,13,LAC,CLE,Home,429,291,335,202,1,1,94,89,0,0,0,0
2017-12-10,14,LAC,WAS,Home,488,201,314,136,2,1,174,65,1,0,1,1
2017-12-16,15,KAN,LAC,Home,397,307,223,209,2,1,174,98,1,1,4,4
2017-12-24,16,NYJ,LAC,Away,295,379,98,290,0,1,197,89,1,1,0,0
2017-12-31,17,LAC,LVR,Home,495,336,380,231,3,1,115,105,0,0,0,0
2018-09-09,1,LAC,KAN,Away,541,362,418,256,3,4,123,106,0,0,2,2
2018-09-16,2,BUF,LAC,Away,293,349,209,240,1,3,84,109,1,1,0,0
2018-09-23,3,LAR,LAC,Home,521,356,350,215,3,2,171,141,1,1,2,2
2018-09-30,4,LAC,SFO,Home,368,364,242,288,3,2,126,76,0,0,1,1
2018-10-07,5,LAC,LVR,Home,412,289,333,248,2,1,79,41,1,0,0,0
2018-10-14,6,CLE,LAC,Away,317,449,214,203,1,2,103,246,0,3,1,1
2018-10-21,7,LAC,TEN,Home,344,390,297,226,2,1,47,164,0,1,0,0
2018-11-04,9,SEA,LAC,Away,356,375,202,215,2,2,154,160,0,1,0,0
2018-11-11,10,LVR,LAC,Away,317,335,203,222,0,2,114,113,0,0,1,1
2018-11-18,11,LAC,DEN,Away,479,325,384,217,2,0,95,108,0,3,2,2
2018-11-25,12,LAC,ARI,Home,414,149,236,87,3,1,178,62,3,0,1,1
2018-12-02,13,PIT,LAC,Away,336,371,271,286,2,2,65,85,2,1,0,0
2018-12-09,14,LAC,CIN,Home,288,295,203,151,1,1,85,144,1,1,0,0
2018-12-13,15,KAN,LAC,Away,294,407,234,288,2,2,60,119,2,2,2,2
2018-12-22,16,LAC,BAL,Away,198,361,147,202,0,1,51,159,1,0,3,3
2018-12-30,17,DEN,LAC,Away,370,276,288,160,1,1,82,116,0,1,4,4
2019-09-08,1,LAC,IND,Home,435,376,310,173,3,2,125,203,1,1,2,2
2019-09-15,2,DET,LAC,Home,339,424,245,287,2,0,94,137,0,1,2,2
2019-09-22,3,LAC,HOU,Away,366,376,293,337,2,3,73,39,0,1,1,1
2019-09-29,4,MIA,LAC,Away,233,390,161,311,1,2,72,79,0,1,0,0
2019-10-06,5,LAC,DEN,Away,246,350,211,159,0,1,35,191,0,1,3,3
2019-10-13,6,LAC,PIT,Away,348,256,316,132,2,1,32,124,0,1,3,3
2019-10-20,7,TEN,LAC,Home,403,365,306,326,2,2,97,39,1,0,1,1
2019-10-27,8,CHI,LAC,Away,388,231,226,195,0,1,162,36,1,1,1,1
2019-11-03,9,LAC,GNB,Home,442,184,283,139,0,1,159,45,2,0,0,0
2019-11-07,10,LVR,LAC,Home,278,315,200,169,1,2,78,146,1,1,3,3
2019-11-18,11,LAC,KAN,Away,438,310,345,180,1,1,93,130,0,2,4,4
2019-12-01,13,DEN,LAC,Home,218,359,134,244,2,2,84,115,0,0,2,2
2019-12-08,14,JAX,LAC,Away,252,525,164,330,1,4,88,195,0,2,0,0
2019-12-15,15,LAC,MIN,Away,345,344,283,207,1,1,62,137,0,2,7,7
2019-12-22,16,LAC,LVR,Away,284,366,265,267,0,1,19,99,2,2,0,0
2019-12-29,17,KAN,LAC,Home,336,366,174,258,1,2,162,108,2,1,2,2
2020-09-13,1,CIN,LAC,Away,295,362,173,207,0,0,122,155,1,1,0,0
2020-09-20,2,LAC,KAN,Away,479,414,296,289,1,2,183,125,1,0,1,1
2020-09-27,3,LAC,CAR,Away,436,302,319,221,1,1,117,81,1,0,4,4
2020-10-04,4,TAM,LAC,Home,484,324,369,278,5,3,115,46,0,0,2,2
2020-10-12,5,NOR,LAC,Home,408,350,313,239,1,4,95,111,2,0,0,0
2020-10-25,7,LAC,JAX,Home,484,294,349,154,3,2,135,140,2,1,0,0
2020-11-01,8,DEN,LAC,Home,351,485,243,275,3,3,108,210,1,0,2,2
2020-11-08,9,LAC,LVR,Away,440,320,312,160,2,2,128,160,1,2,1,1
2020-11-15,10,MIA,LAC,Home,280,273,169,174,2,2,111,99,1,1,1,1
2020-11-22,11,LAC,NYJ,Home,376,292,347,196,3,2,29,96,0,2,1,1
2020-11-29,12,BUF,LAC,Home,332,367,160,291,2,1,172,76,1,1,1,1
2020-12-06,13,LAC,NWE,Away,258,291,188,126,0,2,70,165,0,2,2,2
2020-12-13,14,LAC,ATL,Home,345,319,240,249,2,2,105,70,0,0,1,1
2020-12-17,15,LVR,LAC,Away,449,402,276,306,1,2,173,96,2,2,0,0
2020-12-27,16,LAC,DEN,Home,316,396,227,263,1,0,89,133,0,1,0,0
2021-01-03,17,KAN,LAC,Away,268,416,217,281,2,3,51,135,1,2,0,0
2021-09-12,1,WAS,LAC,Away,259,424,133,334,1,1,126,90,0,1,2,2
2021-09-19,2,LAC,DAL,Away,408,419,313,221,1,0,95,198,0,2,2,2
2021-09-26,3,KAN,LAC,Away,437,352,251,275,3,4,186,77,0,0,0,0
2021-10-04,4,LAC,LVR,Home,380,213,212,165,3,2,168,48,1,0,0,0
2021-10-10,5,LAC,CLE,Home,493,531,381,301,4,2,112,230,3,3,1,1
2021-10-17,6,BAL,LAC,Home,327,208,140,182,1,1,187,26,3,0,1,1
2021-10-31,8,LAC,NWE,Away,369,352,206,210,2,0,163,142,1,1,2,2
2021-11-07,9,PHI,LAC,Away,331,445,155,356,1,2,176,89,2,1,0,0
2021-11-14,10,LAC,MIN,Away,253,381,171,278,1,2,82,103,1,1,1,1
2021-11-21,11,LAC,PIT,Home,533,300,374,245,3,3,159,55,2,1,1,1
2021-11-28,12,DEN,LAC,Home,302,357,155,285,1,2,147,72,2,0,2,2
2021-12-05,13,CIN,LAC,Away,356,363,260,284,1,3,96,79,2,1,3,3
2021-12-12,14,LAC,NYG,Home,423,316,271,181,3,2,152,135,1,1,0,0
2021-12-16,15,LAC,KAN,Away,428,496,236,410,2,3,192,86,2,1,2,2
2021-12-26,16,HOU,LAC,Home,437,417,248,328,2,1,189,89,2,2,3,3
2022-01-02,17,LAC,DEN,Home,341,319,237,236,2,1,104,83,1,0,0,0
2022-01-09,18,LVR,LAC,Home,346,440,172,355,2,3,174,85,1,1,2,2
2022-09-11,1,LAC,LVR,Home,355,320,279,256,3,2,76,64,0,0,0,0
2022-09-15,2,KAN,LAC,Home,319,401,226,326,2,3,93,75,0,0,1,1
2022-09-25,3,LAC,JAX,Away,312,413,286,262,1,3,26,151,0,1,2,2
2022-10-02,4,HOU,LAC,Away,346,419,215,338,2,2,131,81,1,2,1,1
2022-10-09,5,CLE,LAC,Away,443,465,230,227,1,1,213,238,3,2,0,0
2022-10-17,6,LAC,DEN,Home,297,258,224,160,0,1,73,98,1,0,1,1
2022-10-23,7,LAC,SEA,Away,329,404,276,191,2,2,53,213,1,2,2,2
2022-11-06,9,ATL,LAC,Away,315,336,114,245,0,1,201,91,2,1,2,2
2022-11-13,10,SFO,LAC,Home,387,238,230,187,0,1,157,51,2,0,1,1
2022-11-20,11,LAC,KAN,Away,365,485,250,322,2,3,115,163,1,0,2,2
2022-11-27,12,ARI,LAC,Away,366,311,185,246,2,3,181,65,1,0,0,0
2022-12-04,13,LVR,LAC,Home,404,386,250,314,2,1,154,72,1,0,1,1
2022-12-11,14,LAC,MIA,Home,432,219,350,127,1,1,82,92,1,0,0,0
2022-12-18,15,LAC,TEN,Home,365,284,291,157,0,0,74,127,2,2,2,2
2022-12-26,16,IND,LAC,Away,173,314,104,213,0,0,69,101,0,2,2,2
2023-01-01,17,LAC,LAR,Home,431,277,239,111,2,0,192,166,2,1,0,0
2023-01-08,18,DEN,LAC,Home,471,352,266,293,3,3,205,59,1,0,2,2
2023-09-10,1,LAC,MIA,Away,433,536,200,466,1,3,233,70,3,1,0,0
2023-09-17,2,TEN,LAC,Home,341,342,200,281,1,2,141,61,2,0,0,0
2023-09-24,3,MIN,LAC,Away,475,475,345,445,3,4,130,30,0,0,1,1
2023-10-01,4,LAC,LVR,Home,305,264,150,188,1,0,155,76,2,2,1,1
2023-10-16,6,LAC,DAL,Away,272,342,219,246,2,1,53,96,0,1,1,1
2023-10-22,7,KAN,LAC,Home,483,358,415,219,4,1,68,139,0,1,2,2
2023-10-29,8,LAC,CHI,Home,352,295,298,222,3,0,54,73,0,2,1,1
2023-11-06,9,NYJ,LAC,Away,270,191,206,107,0,0,64,84,0,2,0,0
2023-11-12,10,LAC,DET,Away,421,533,323,333,4,2,98,200,1,3,1,1
2023-11-19,11,GNB,LAC,Home,397,394,295,244,2,2,102,150,1,0,1,1
2023-11-26,12,LAC,BAL,Away,279,361,193,164,1,1,86,197,0,1,4,4
2023-12-03,13,NWE,LAC,Away,257,241,109,212,0,0,148,29,0,0,0,0
2023-12-10,14,LAC,DEN,Away,283,322,207,216,0,2,76,106,1,1,2,2
2023-12-14,15,LVR,LAC,Home,378,326,254,234,5,3,124,92,2,0,5,5
2023-12-23,16,LAC,BUF,Away,273,335,175,230,0,1,98,105,1,2,0,0
2023-12-31,17,DEN,LAC,Home,313,301,212,215,1,0,101,86,0,0,1,1
2024-01-07,18,LAC,KAN,Away,353,268,235,145,0,0,118,123,0,0,1,1
2014-09-07,1,LAR,MIN,Away,318,355,246,170,0,2,72,185,0,1,2,2
2014-09-14,2,TAM,LAR,Away,332,339,175,220,0,0,157,119,2,1,1,1
2014-09-21,3,LAR,DAL,Away,448,340,327,217,3,2,121,123,0,1,3,3
2014-10-05,5,PHI,LAR,Home,352,466,207,341,2,3,145,125,0,1,3,3
2014-10-13,6,LAR,SFO,Away,309,432,216,343,1,3,93,89,1,0,1,1
2014-10-19,7,LAR,SEA,Home,275,463,173,292,2,2,102,171,1,1,0,0
2014-10-26,8,KAN,LAR,Home,355,200,215,116,0,1,140,84,3,0,1,1
2014-11-02,9,SFO,LAR,Away,263,193,183,102,1,1,80,91,0,0,2,2
2014-11-09,10,ARI,LAR,Home,335,244,307,174,1,1,28,70,1,1,3,3
2014-11-16,11,LAR,DEN,Home,337,397,206,369,1,1,131,28,0,0,0,0
2014-11-23,12,LAC,LAR,Home,410,317,282,210,1,1,128,107,1,1,3,3
2014-11-30,13,LAR,LVR,Home,348,244,176,183,2,0,172,61,4,0,0,0
2014-12-07,14,WAS,LAR,Away,206,329,179,198,0,2,27,131,0,0,0,0
2014-12-11,15,LAR,ARI,Away,280,274,211,131,0,0,69,143,0,0,2,2
2014-12-21,16,LAR,NYG,Away,387,514,281,386,2,3,106,128,1,1,3,3
2014-12-28,17,SEA,LAR,Home,354,245,222,203,0,0,132,42,1,0,3,3
2015-09-13,1,LAR,SEA,Home,352,343,276,219,1,1,76,124,2,0,3,3
2015-09-20,2,WAS,LAR,Home,373,213,191,146,1,1,182,67,2,0,0,0
2015-09-27,3,LAR,PIT,Away,258,259,187,197,0,0,71,62,0,1,1,1
2015-10-04,4,ARI,LAR,Away,447,328,334,164,1,3,113,164,0,0,0,0
2015-10-11,5,GNB,LAR,Home,322,334,236,143,2,1,86,191,0,0,4,4
2015-10-25,7,LAR,CLE,Home,308,364,150,282,0,0,158,82,2,0,1,1
2015-11-01,8,LAR,SFO,Home,388,189,191,151,1,0,197,38,2,0,1,1
2015-11-08,9,MIN,LAR,Home,293,320,148,160,0,0,145,160,2,1,0,0
2015-11-15,10,LAR,CHI,Away,285,397,191,244,0,3,94,153,1,1,2,2
2015-11-22,11,BAL,LAR,Home,388,213,292,131,1,1,96,82,0,1,4,4
2015-11-29,12,CIN,LAR,Home,376,345,236,251,3,0,140,94,0,1,3,3
2015-12-06,13,LAR,ARI,Away,212,524,146,349,0,2,66,175,0,1,1,1
2015-12-13,14,LAR,DET,Home,317,331,114,220,0,2,203,111,2,0,2,2
2015-12-17,15,LAR,TAM,Home,319,509,221,363,2,2,98,146,2,0,0,0
2015-12-27,16,SEA,LAR,Away,312,205,253,103,2,1,59,102,0,1,0,0
2016-01-03,17,SFO,LAR,Home,458,364,350,231,1,0,108,133,0,1,0,0
2016-09-12,1,SFO,LAR,Home,320,185,170,120,1,0,150,65,3,0,2,2
2016-09-18,2,LAR,SEA,Home,283,306,219,239,0,0,64,67,0,0,0,0
2016-09-25,3,TAM,LAR,Away,472,320,389,183,3,2,83,137,1,2,2,2
2016-10-02,4,ARI,LAR,Away,420,288,302,247,1,2,118,41,0,0,1,1
2016-10-09,5,LAR,BUF,Away,345,305,243,112,0,2,102,193,1,1,3,3
2016-10-16,6,DET,LAR,Home,348,387,265,311,4,3,83,76,0,1,1,1
2016-10-23,7,LAR,NYG,Away,345,232,271,196,1,0,74,36,0,1,4,4
2016-11-06,9,LAR,CAR,Away,339,244,280,185,1,1,59,59,0,0,1,1
2016-11-13,10,NYJ,LAR,Away,296,280,157,155,1,0,139,125,0,0,0,0
2016-11-20,11,LAR,MIA,Away,227,240,125,142,0,2,102,98,1,0,1,1
2016-11-27,12,NOR,LAR,Home,555,247,346,178,5,3,209,69,2,0,2,2
2016-12-04,13,NWE,LAR,Home,402,162,269,126,1,1,133,36,1,0,2,2
2016-12-11,14,LAR,ATL,Away,312,286,208,220,0,3,104,66,2,1,5,5
2016-12-15,15,SEA,LAR,Home,299,183,227,136,3,0,72,47,0,0,0,0
2016-12-24,16,LAR,SFO,Away,177,323,78,253,1,2,99,70,2,1,2,2
2017-01-01,17,LAR,ARI,Away,123,344,71,260,0,3,52,84,0,1,3,3
2017-09-10,1,LAR,IND,Home,373,225,310,150,1,0,63,75,2,1,1,1
2017-09-17,2,LAR,WAS,Away,332,385,235,156,1,1,97,229,1,2,2,2
2017-09-21,3,SFO,LAR,Away,421,418,308,292,2,3,113,126,3,2,2,2
2017-10-01,4,DAL,LAR,Away,440,412,251,244,3,2,189,168,1,0,0,0
2017-10-08,5,LAR,SEA,Away,375,241,275,179,0,1,100,62,1,0,5,5
2017-10-15,6,JAX,LAR,Away,389,249,220,107,1,1,169,142,1,0,1,1
2017-10-22,7,LAR,ARI,Home,425,196,228,171,1,0,197,25,2,0,1,1
2017-11-05,9,NYG,LAR,Away,319,473,208,311,2,4,111,162,0,2,0,0
2017-11-12,10,LAR,HOU,Home,443,283,339,194,3,1,104,89,0,0,0,0
2017-11-19,11,MIN,LAR,Home,451,254,280,209,1,0,171,45,2,1,1,1
2017-11-26,12,LAR,NOR,Home,415,346,327,223,2,1,88,123,0,1,1,1
2017-12-03,13,ARI,LAR,Away,305,303,187,213,1,2,118,90,1,0,1,1
2017-12-10,14,LAR,PHI,Away,307,455,198,316,2,4,109,139,2,0,2,2
2017-12-17,15,SEA,LAR,Away,149,352,71,108,1,2,78,244,0,3,1,1
2017-12-24,16,TEN,LAR,Away,366,402,269,286,0,4,97,116,1,0,1,1
2017-12-31,17,LAR,SFO,Away,251,461,149,292,0,2,102,169,1,2,2,2
2018-09-10,1,LVR,LAR,Away,395,365,300,225,0,2,95,140,1,0,0,0
2018-09-16,2,LAR,ARI,Home,432,137,342,83,1,0,90,54,3,0,1,1
2018-09-23,3,LAR,LAC,Home,521,356,350,215,3,2,171,141,1,1,2,2
2018-09-27,4,LAR,MIN,Home,556,446,456,392,5,3,100,54,0,0,0,0
2018-10-07,5,SEA,LAR,Away,373,468,183,313,3,1,190,155,1,3,2,2
2018-10-14,6,DEN,LAR,Away,357,444,297,174,2,0,60,270,0,2,1,1
2018-10-21,7,SFO,LAR,Away,228,339,121,193,1,2,107,146,0,2,0,0
2018-10-28,8,LAR,GNB,Home,416,359,281,253,3,1,135,106,0,2,0,0
2018-11-04,9,NOR,LAR,Home,487,483,346,391,4,3,141,92,2,1,1,1
2018-11-11,10,LAR,SEA,Home,456,414,307,141,2,3,149,273,2,1,0,0
2018-11-19,11,LAR,KAN,Home,455,546,379,448,4,6,76,98,1,0,2,2
2018-12-02,13,DET,LAR,Away,310,344,208,195,1,1,102,149,0,2,2,2
2018-12-09,14,CHI,LAR,Home,294,214,100,162,1,0,194,52,0,0,4,4
2018-12-16,15,LAR,PHI,Away,407,381,325,270,0,0,82,111,2,3,3,3
2018-12-23,16,ARI,LAR,Away,263,461,159,192,1,1,104,269,0,3,1,1
2018-12-30,17,LAR,SFO,Home,377,391,222,264,4,3,155,127,1,1,0,0
2019-09-08,1,CAR,LAR,Away,343,349,216,183,0,1,127,166,3,2,1,1
2019-09-15,2,LAR,NOR,Home,380,244,265,187,1,0,115,57,2,0,1,1
2019-09-22,3,CLE,LAR,Away,270,344,175,254,1,2,95,90,0,0,3,3
2019-09-29,4,LAR,TAM,Away,518,464,490,376,2,4,28,88,2,2,4,4
2019-10-03,5,SEA,LAR,Home,429,477,262,395,4,1,167,82,0,2,2,2
2019-10-13,6,LAR,SFO,Away,157,331,48,232,0,0,109,99,1,2,1,1
2019-10-20,7,ATL,LAR,Away,224,381,186,291,1,2,38,90,0,1,0,0
2019-10-27,8,LAR,CIN,Home,470,401,372,297,2,1,98,104,1,0,0,0
2019-11-10,10,PIT,LAR,Home,273,306,231,218,1,0,42,88,0,0,4,4
2019-11-17,11,LAR,CHI,Home,283,267,173,193,0,1,110,74,2,0,2,2
2019-11-25,12,LAR,BAL,Away,221,480,199,195,0,5,22,285,0,1,2,2
2019-12-01,13,ARI,LAR,Away,198,549,124,417,0,2,74,132,1,1,0,0
2019-12-08,14,LAR,SEA,Home,455,308,293,202,2,0,162,106,2,0,2,2
2019-12-15,15,DAL,LAR,Home,475,289,212,267,2,2,263,22,3,1,1,1
2019-12-21,16,SFO,LAR,Home,334,395,215,323,1,2,119,72,2,2,1,1
2019-12-29,17,LAR,ARI,Home,424,393,311,322,3,2,113,71,1,1,0,0
2020-09-13,1,LAR,DAL,Home,422,380,269,244,0,1,153,136,2,1,1,1
2020-09-20,2,PHI,LAR,Away,363,449,242,258,0,3,121,191,2,2,1,1
2020-09-27,3,BUF,LAR,Home,375,478,274,311,4,2,101,167,1,2,2,2
2020-10-04,4,LAR,NYG,Home,240,295,182,159,1,0,58,136,1,0,1,1
2020-10-11,5,WAS,LAR,Away,108,429,70,300,0,2,38,129,1,2,1,1
2020-10-18,6,SFO,LAR,Home,390,311,268,198,3,2,122,113,0,0,1,1
2020-10-26,7,LAR,CHI,Home,371,279,211,230,2,0,160,49,1,0,1,1
2020-11-01,8,MIA,LAR,Home,145,471,90,340,1,1,55,131,1,1,4,4
2020-11-15,10,LAR,SEA,Home,389,333,283,220,0,0,106,113,3,1,1,1
2020-11-23,11,TAM,LAR,Away,251,413,209,376,2,3,42,37,1,0,2,2
2020-11-29,12,LAR,SFO,Away,308,345,182,233,0,0,126,112,1,1,4,4
2020-12-06,13,ARI,LAR,Away,232,463,140,344,3,1,92,119,1,3,1,1
2020-12-10,14,LAR,NWE,Home,318,220,132,113,1,0,186,107,1,0,1,1
2020-12-20,15,LAR,NYJ,Away,303,289,189,196,2,1,114,93,0,1,1,1
2020-12-27,16,SEA,LAR,Home,292,334,197,216,1,0,95,118,1,0,1,1
2021-01-03,17,LAR,ARI,Home,333,214,223,166,0,1,110,48,0,0,2,2
2021-09-12,1,LAR,CHI,Home,386,322,312,188,3,0,74,134,1,2,0,0
2021-09-19,2,IND,LAR,Away,354,371,245,270,1,2,109,101,0,1,2,2
2021-09-26,3,LAR,TAM,Home,407,446,331,411,4,1,76,35,0,2,0,0
2021-10-03,4,LAR,ARI,Away,401,465,280,249,2,2,121,216,0,2,2,2
2021-10-07,5,SEA,LAR,Away,354,476,262,358,2,1,92,118,0,2,1,1
2021-10-17,6,NYG,LAR,Away,261,365,201,234,0,4,60,131,1,1,2,2
2021-10-24,7,LAR,DET,Home,374,415,327,278,3,1,47,137,0,0,0,0
2021-10-31,8,HOU,LAR,Away,323,467,279,302,2,3,44,165,1,2,0,0
2021-11-07,9,LAR,TEN,Away,347,194,253,125,1,1,94,69,0,2,2,2
2021-11-15,10,SFO,LAR,Home,335,278,179,226,2,1,156,52,1,0,2,2
2021-11-28,12,GNB,LAR,Home,399,353,307,285,2,3,92,68,1,0,3,3
2021-12-05,13,LAR,JAX,Home,418,197,290,136,3,0,128,61,1,1,0,0
2021-12-13,14,ARI,LAR,Away,447,356,344,267,0,3,103,89,2,0,0,0
2021-12-21,15,LAR,SEA,Home,332,214,209,134,2,0,123,80,0,1,1,1
2021-12-26,16,MIN,LAR,Away,361,356,295,197,1,1,66,159,1,1,3,3
2022-01-02,17,BAL,LAR,Away,327,373,162,300,0,2,165,73,0,1,3,3
2022-01-09,18,LAR,SFO,Away,265,449,201,314,3,2,64,135,0,1,2,2
2022-09-08,1,LAR,BUF,Away,243,413,191,292,1,3,52,121,0,1,3,3
2022-09-18,2,LAR,ATL,Home,337,261,272,171,3,2,65,90,1,0,3,3
2022-09-25,3,ARI,LAR,Away,365,339,295,239,0,0,70,100,0,2,1,1
2022-10-03,4,SFO,LAR,Home,327,257,239,200,1,0,88,57,1,0,2,2
2022-10-09,5,LAR,DAL,Away,323,239,285,76,1,0,38,163,0,1,3,3
2022-10-16,6,LAR,CAR,Home,360,203,249,110,1,0,111,93,2,0,1,1
2022-10-30,8,LAR,SFO,Away,223,368,167,257,1,3,56,111,1,1,0,0
2022-11-06,9,TAM,LAR,Home,323,206,272,138,1,1,51,68,0,0,0,0
2022-11-13,10,LAR,ARI,Away,256,298,190,220,1,1,66,78,1,2,2,2
2022-11-20,11,NOR,LAR,Home,323,336,235,188,3,2,88,148,0,0,0,0
2022-11-27,12,KAN,LAR,Home,437,198,320,82,1,1,117,116,1,0,2,2
2022-12-04,13,LAR,SEA,Away,319,438,148,348,0,3,171,90,2,0,2,2
2022-12-08,14,LAR,LVR,Home,282,302,211,137,1,0,71,165,1,1,1,1
2022-12-19,15,GNB,LAR,Home,345,156,207,84,1,1,138,72,2,0,1,1
2022-12-25,16,LAR,DEN,Home,388,323,230,219,2,1,158,104,3,0,0,0
2023-01-01,17,LAC,LAR,Home,431,277,239,111,2,0,192,166,2,1,1,1
2023-01-08,18,SEA,LAR,Home,402,269,205,123,1,0,197,146,0,1,1,1
2023-09-10,1,SEA,LAR,Away,180,426,95,334,1,0,85,92,0,3,0,0
2023-09-17,2,LAR,SFO,Away,386,365,297,206,1,0,89,159,1,3,2,2
2023-09-25,3,CIN,LAR,Home,309,292,242,221,0,1,67,71,1,0,2,2
2023-10-01,4,IND,LAR,Away,329,467,196,303,2,1,133,164,1,2,1,1
2023-10-08,5,LAR,PHI,Away,249,454,195,295,2,1,54,159,0,1,0,0
2023-10-15,6,LAR,ARI,Home,382,345,203,215,1,0,179,130,1,0,1,1
2023-10-22,7,LAR,PIT,Away,354,300,219,214,1,0,135,86,1,3,1,1
2023-10-29,8,DAL,LAR,Home,387,280,285,188,4,1,102,92,0,1,1,1
2023-11-05,9,GNB,LAR,Home,391,187,207,119,1,0,184,68,1,0,2,2
2023-11-19,11,LAR,SEA,Home,267,291,185,223,1,1,82,68,1,0,1,1
2023-11-26,12,ARI,LAR,Away,292,457,219,229,1,4,73,228,1,1,1,1
2023-12-03,13,LAR,CLE,Home,399,327,279,240,3,2,120,87,1,0,0,0
2023-12-10,14,BAL,LAR,Home,449,410,310,282,3,3,139,128,0,0,0,0
2023-12-17,15,LAR,WAS,Home,445,297,249,218,2,3,196,79,1,0,2,2
2023-12-21,16,LAR,NOR,Home,458,339,325,304,2,3,133,35,1,0,0,0
2023-12-31,17,NYG,LAR,Away,389,391,284,286,1,1,105,105,1,3,3,3
2024-01-07,18,SFO,LAR,Away,300,258,175,149,1,2,125,109,2,1,1,1
2014-09-07,1,NYJ,LVR,Home,402,158,190,133,1,2,212,25,1,0,0,0
2014-09-14,2,LVR,HOU,Away,364,327,263,139,1,2,101,188,1,1,4,4
2014-09-21,3,NWE,LVR,Home,297,241,221,174,1,0,76,67,0,0,1,1
2014-09-28,4,LVR,MIA,Away,317,435,264,278,2,2,53,157,0,2,4,4
2014-10-12,6,LVR,LAC,Away,396,423,282,307,4,3,114,116,0,1,1,1
2014-10-19,7,LVR,ARI,Away,220,365,164,242,0,2,56,123,1,1,0,0
2014-10-26,8,CLE,LVR,Home,306,387,267,311,1,1,39,76,1,0,3,3
2014-11-02,9,SEA,LVR,Home,326,226,177,189,0,2,149,37,2,0,3,3
2014-11-09,10,LVR,DEN,Away,222,471,192,353,2,5,30,118,0,0,3,3
2014-11-16,11,LAC,LVR,Home,300,233,180,162,1,0,120,71,0,0,1,1
2014-11-20,12,LVR,KAN,Home,351,313,172,217,1,2,179,96,2,0,1,1
2014-11-30,13,LAR,LVR,Home,348,244,176,183,2,0,172,61,4,0,5,5
2014-12-07,14,LVR,SFO,Home,330,248,245,151,3,1,85,97,0,0,0,0
2014-12-14,15,KAN,LVR,Home,388,280,295,202,2,1,93,78,1,0,1,1
2014-12-21,16,LVR,BUF,Home,347,321,207,308,2,3,140,13,0,0,0,0
2014-12-28,17,DEN,LVR,Home,451,199,309,132,1,1,142,67,3,0,2,2
2015-09-13,1,LVR,CIN,Away,246,396,183,269,2,2,63,127,0,2,2,2
2015-09-20,2,LVR,BAL,Home,448,493,351,384,3,2,97,109,1,1,1,1
2015-09-27,3,CLE,LVR,Away,355,469,316,314,2,2,39,155,0,1,1,1
2015-10-04,4,CHI,LVR,Home,371,243,273,173,2,2,98,70,0,0,2,2
2015-10-11,5,LVR,DEN,Away,288,297,223,254,1,0,65,43,0,0,3,3
2015-10-25,7,LAC,LVR,Away,417,412,327,282,3,3,90,130,0,1,0,0
2015-11-01,8,LVR,NYJ,Home,451,366,333,292,4,2,118,74,0,0,0,0
2015-11-08,9,PIT,LVR,Home,597,440,402,301,2,4,195,139,2,1,4,4
2015-11-15,10,LVR,MIN,Away,371,385,287,122,2,1,84,263,0,1,2,2
2015-11-22,11,DET,LVR,Home,375,216,266,164,0,0,109,52,1,1,0,0
2015-11-29,12,TEN,LVR,Away,249,407,205,323,3,3,44,84,0,0,2,2
2015-12-06,13,LVR,KAN,Away,361,232,262,143,2,2,99,89,1,2,3,3
2015-12-13,14,DEN,LVR,Away,310,126,276,99,0,2,34,27,0,0,0,0
2015-12-20,15,LVR,GNB,Away,372,293,252,190,2,1,120,103,0,1,2,2
2015-12-24,16,LVR,LAC,Home,281,343,175,271,1,1,106,72,1,1,1,1
2016-01-03,17,KAN,LVR,Home,339,205,150,157,2,1,189,48,1,0,1,1
2016-09-11,1,NOR,LVR,Away,507,486,419,319,4,1,88,167,0,3,0,0
2016-09-18,2,LVR,ATL,Away,454,528,299,389,3,3,155,139,1,1,0,0
2016-09-25,3,TEN,LVR,Away,393,368,212,245,0,1,181,123,1,1,1,1
2016-10-02,4,BAL,LVR,Away,412,261,282,199,1,4,130,62,2,0,1,1
2016-10-09,5,LVR,LAC,Home,389,423,300,351,2,4,89,72,1,0,1,1
2016-10-16,6,LVR,KAN,Away,285,406,221,223,1,0,64,183,0,3,2,2
2016-10-23,7,JAX,LVR,Away,344,344,239,200,1,1,105,144,0,2,0,0
2016-10-30,8,TAM,LVR,Away,270,626,168,498,2,4,102,128,1,0,1,1
2016-11-06,9,LVR,DEN,Home,397,299,179,266,0,2,218,33,3,0,0,0
2016-11-21,11,LVR,HOU,Home,325,354,295,230,3,1,30,124,0,1,1,1
2016-11-27,12,LVR,CAR,Home,366,358,310,229,2,2,56,129,1,3,2,2
2016-12-04,13,LVR,BUF,Home,399,382,260,170,2,0,139,212,2,3,0,0
2016-12-08,14,KAN,LVR,Home,323,244,258,109,1,0,65,135,1,1,0,0
2016-12-18,15,LAC,LVR,Away,263,345,190,200,2,1,73,145,0,0,2,2
2016-12-24,16,LVR,IND,Home,463,390,253,288,3,2,210,102,2,1,0,0
2017-01-01,17,DEN,LVR,Home,349,221,206,164,2,1,143,57,1,0,3,3
2017-09-10,1,TEN,LVR,Away,350,359,255,250,0,2,95,109,1,0,0,0
2017-09-17,2,LVR,NYJ,Home,410,271,230,145,3,2,180,126,3,0,0,0
2017-09-24,3,WAS,LVR,Home,472,128,356,96,3,1,116,32,0,0,3,3
2017-10-01,4,DEN,LVR,Home,298,254,155,230,1,1,143,24,0,0,1,1
2017-10-08,5,LVR,BAL,Away,245,365,137,222,1,0,108,143,1,2,1,1
2017-10-15,6,LVR,LAC,Away,274,343,165,263,1,1,109,80,1,1,2,2
2017-10-19,7,LVR,KAN,Home,505,425,417,331,3,3,88,94,1,0,0,0
2017-10-29,8,BUF,LVR,Home,331,367,165,313,1,1,166,54,2,1,4,4
2017-11-05,9,MIA,LVR,Away,395,379,309,295,3,1,86,84,0,2,2,2
2017-11-19,11,LVR,NWE,Away,344,421,235,332,1,3,109,89,0,0,2,2
2017-11-26,12,LVR,DEN,Home,348,216,244,160,2,2,104,56,1,0,1,1
2017-12-03,13,LVR,NYG,Home,401,265,282,200,1,1,119,65,2,1,1,1
2017-12-10,14,KAN,LVR,Home,408,268,243,198,0,1,165,70,2,1,3,3
2017-12-17,15,LVR,DAL,Away,293,330,171,204,2,0,122,126,0,2,1,1
2017-12-25,16,PHI,LVR,Home,216,274,138,137,1,1,78,137,0,0,5,5
2017-12-31,17,LAC,LVR,Home,495,336,380,231,3,1,115,105,0,0,2,2
2018-09-10,1,LVR,LAR,Away,395,365,300,225,0,2,95,140,1,0,3,3
2018-09-16,2,DEN,LVR,Home,385,373,217,281,0,1,168,92,2,1,0,0
2018-09-23,3,MIA,LVR,Home,373,434,332,325,4,1,41,109,0,1,2,2
2018-09-30,4,LVR,CLE,Home,565,487,426,279,4,2,139,208,0,3,2,2
2018-10-07,5,LAC,LVR,Home,412,289,333,248,2,1,79,41,1,0,2,2
2018-10-14,6,LVR,SEA,Away,185,369,106,214,0,3,79,155,0,0,2,2
2018-10-28,8,LVR,IND,Away,347,461,244,239,3,3,103,222,1,2,1,1
2018-11-01,9,SFO,LVR,Home,405,242,262,140,3,0,143,102,1,0,0,0
2018-11-11,10,LVR,LAC,Away,317,335,203,222,0,2,114,113,0,0,1,1
2018-11-18,11,ARI,LVR,Away,282,325,128,173,3,2,154,152,0,0,0,0
2018-11-25,12,BAL,LVR,Home,416,249,174,182,1,1,242,67,1,1,1,1
2018-12-02,13,LVR,KAN,Away,442,469,271,295,3,4,171,174,1,1,3,3
2018-12-09,14,LVR,PIT,Home,354,340,299,300,2,2,55,40,1,1,1,1
2018-12-16,15,CIN,LVR,Home,294,297,123,229,1,1,171,68,2,0,2,2
2018-12-24,16,LVR,DEN,Home,273,300,159,200,0,2,114,100,2,0,0,0
2018-12-30,17,KAN,LVR,Home,409,292,310,165,2,0,99,127,2,0,4,4
2019-09-09,1,LVR,DEN,Home,357,344,259,249,1,1,98,95,2,0,0,0
2019-09-15,2,LVR,KAN,Away,307,467,178,436,1,4,129,31,0,0,2,2
2019-09-22,3,MIN,LVR,Home,385,302,174,214,1,2,211,88,3,0,1,1
2019-09-29,4,IND,LVR,Away,346,377,265,189,3,2,81,188,0,1,1,1
2019-10-06,5,LVR,CHI,Home,398,236,229,194,0,2,169,42,3,1,2,2
2019-10-20,7,GNB,LVR,Home,481,484,421,329,5,3,60,155,1,0,2,2
2019-10-27,8,HOU,LVR,Home,388,378,258,285,3,3,130,93,0,0,0,0
2019-11-03,9,LVR,DET,Home,450,473,279,383,2,3,171,90,2,0,0,0
2019-11-07,10,LVR,LAC,Home,278,315,200,169,1,2,78,146,1,1,0,0
2019-11-17,11,LVR,CIN,Home,386,246,273,73,1,0,113,173,1,1,2,2
2019-11-24,12,NYJ,LVR,Home,401,208,313,140,2,0,88,68,1,0,2,2
2019-12-01,13,KAN,LVR,Home,259,332,163,210,1,1,96,122,3,0,3,3
2019-12-08,14,LVR,TEN,Away,355,552,258,391,2,3,97,161,1,2,1,1
2019-12-15,15,LVR,JAX,Away,364,262,236,185,1,2,128,77,0,0,0,0
2019-12-22,16,LAC,LVR,Away,284,366,265,267,0,1,19,99,2,2,0,0
2019-12-29,17,DEN,LVR,Home,238,477,168,380,1,1,70,97,0,0,1,1
2020-09-13,1,CAR,LVR,Away,388,372,259,239,1,1,129,133,2,3,0,0
2020-09-21,2,LVR,NOR,Home,377,424,261,312,3,1,116,112,1,2,1,1
2020-09-27,3,NWE,LVR,Home,406,375,156,249,1,2,250,126,2,0,3,3
2020-10-04,4,LVR,BUF,Away,383,337,297,274,2,2,86,63,0,2,2,2
2020-10-11,5,KAN,LVR,Away,413,490,333,346,2,3,80,144,2,2,1,1
2020-10-25,7,LVR,TAM,Away,347,454,271,369,2,4,76,85,0,2,1,1
2020-11-01,8,CLE,LVR,Away,223,309,122,100,0,1,101,209,0,0,0,0
2020-11-08,9,LAC,LVR,Away,440,320,312,160,2,2,128,160,1,2,1,1
2020-11-15,10,LVR,DEN,Home,357,313,154,247,0,1,203,66,4,0,0,0
2020-11-22,11,LVR,KAN,Away,364,460,275,352,3,2,89,108,1,3,1,1
2020-11-29,12,ATL,LVR,Home,304,243,179,203,2,0,125,40,1,0,5,5
2020-12-06,13,NYJ,LVR,Away,376,440,170,368,2,3,206,72,2,1,2,2
2020-12-13,14,LVR,IND,Away,424,456,345,244,2,2,79,212,1,2,3,3
2020-12-17,15,LVR,LAC,Away,449,402,276,306,1,2,173,96,2,2,1,1
2020-12-26,16,LVR,MIA,Away,418,383,314,253,1,2,104,130,1,0,1,1
2021-01-03,17,DEN,LVR,Away,446,465,324,359,2,2,122,106,1,2,4,4
2021-09-13,1,LVR,BAL,Home,491,406,409,217,2,1,82,189,2,2,1,1
2021-09-19,2,PIT,LVR,Away,331,425,292,373,1,2,39,52,1,0,0,0
2021-09-26,3,LVR,MIA,Home,497,330,357,197,2,0,140,133,1,2,1,1
2021-10-04,4,LAC,LVR,Home,380,213,212,165,3,2,168,48,1,0,1,1
2021-10-10,5,LVR,CHI,Away,259,252,188,109,0,1,71,143,1,1,1,1
2021-10-17,6,DEN,LVR,Away,421,426,309,340,3,2,112,86,0,2,0,0
2021-10-24,7,LVR,PHI,Home,442,358,323,223,2,2,119,135,2,1,1,1
2021-11-07,9,NYG,LVR,Home,247,403,98,286,1,1,149,117,0,0,3,3
2021-11-14,10,LVR,KAN,Away,299,516,249,422,2,5,50,94,0,0,2,2
2021-11-21,11,LVR,CIN,Away,278,288,206,129,1,1,72,159,0,2,2,2
2021-11-25,12,DAL,LVR,Away,437,509,373,366,2,1,64,143,1,2,0,0
2021-12-05,13,LVR,WAS,Away,310,298,234,186,0,2,76,112,1,0,0,0
2021-12-12,14,KAN,LVR,Home,372,290,240,246,2,1,132,44,3,0,5,5
2021-12-20,15,CLE,LVR,Away,236,328,147,230,1,1,89,98,1,0,2,2
2021-12-26,16,LVR,DEN,Home,342,158,182,140,1,0,160,18,1,1,3,3
2022-01-02,17,IND,LVR,Away,262,326,140,241,1,1,122,85,1,1,2,2
2022-01-09,18,LVR,LAC,Home,346,440,172,355,2,3,174,85,1,1,0,0
2022-09-11,1,LAC,LVR,Home,355,320,279,256,3,2,76,64,0,0,3,3
2022-09-18,2,LVR,ARI,Away,324,413,244,270,2,1,80,143,0,2,1,1
2022-09-25,3,TEN,LVR,Home,361,396,252,300,1,2,109,96,2,0,1,1
2022-10-02,4,LVR,DEN,Home,385,299,173,214,0,2,212,85,2,1,0,0
2022-10-10,5,KAN,LVR,Home,368,378,265,223,4,2,103,155,0,1,0,0
2022-10-23,7,LVR,HOU,Home,400,404,236,296,1,2,164,108,3,0,0,0
2022-10-30,8,NOR,LVR,Home,367,183,231,145,2,0,136,38,1,0,1,1
2022-11-06,9,JAX,LVR,Home,403,321,235,248,1,2,168,73,2,0,1,1
2022-11-13,10,LVR,IND,Away,309,415,232,208,2,1,77,207,1,2,0,0
2022-11-20,11,DEN,LVR,Away,320,407,226,298,0,2,94,109,1,0,0,0
2022-11-27,12,SEA,LVR,Away,372,576,307,293,2,3,65,283,2,2,2,2
2022-12-04,13,LVR,LAC,Home,404,386,250,314,2,1,154,72,1,0,2,2
2022-12-08,14,LAR,LVR,Home,282,302,211,137,1,0,71,165,1,1,2,2
2022-12-18,15,LVR,NWE,Home,308,318,211,112,3,0,97,206,0,1,1,1
2022-12-24,16,PIT,LVR,Home,350,201,244,143,1,1,106,58,0,0,3,3
2023-01-01,17,LVR,SFO,Away,500,454,365,284,3,2,135,170,1,2,2,2
2023-01-07,18,LVR,KAN,Away,279,349,180,181,1,1,99,168,0,3,2,2
2023-09-10,1,DEN,LVR,Away,260,261,166,200,2,2,94,61,0,0,1,1
2023-09-17,2,BUF,LVR,Home,450,240,267,185,3,1,183,55,2,0,3,3
2023-09-24,3,LVR,PIT,Away,362,333,293,228,2,2,69,105,0,0,3,3
2023-10-01,4,LAC,LVR,Home,305,264,150,188,1,0,155,76,2,2,3,3
2023-10-09,5,LVR,GNB,Home,279,285,183,175,1,0,96,110,1,1,1,1
2023-10-15,6,LVR,NWE,Home,348,259,264,176,1,0,84,83,0,2,1,1
2023-10-22,7,CHI,LVR,Home,323,235,150,196,1,1,173,39,2,0,3,3
2023-10-30,8,DET,LVR,Home,486,157,264,77,1,0,222,80,1,1,1,1
2023-11-05,9,LVR,NYG,Home,334,277,209,154,0,1,125,123,3,0,0,0
2023-11-12,10,LVR,NYJ,Home,274,365,126,257,1,0,148,108,0,0,2,2
2023-11-19,11,MIA,LVR,Home,422,296,323,260,2,1,99,36,0,0,3,3
2023-11-26,12,LVR,KAN,Away,358,360,235,291,1,2,123,69,1,2,0,0
2023-12-10,14,LVR,MIN,Away,202,231,146,99,0,0,56,132,0,0,3,3
2023-12-14,15,LVR,LAC,Home,378,326,254,234,5,3,124,92,2,0,0,0
2023-12-25,16,KAN,LVR,Away,308,205,223,48,1,0,85,157,1,0,0,0
2023-12-31,17,IND,LVR,Home,349,370,215,286,1,2,134,84,1,0,0,0
2024-01-07,18,LVR,DEN,Home,359,286,230,238,2,1,129,48,1,1,0,0
2014-09-07,1,MIA,NWE,Home,360,315,169,226,2,1,191,89,1,1,3,3
2014-09-14,2,BUF,MIA,Home,315,290,202,210,1,1,113,80,0,0,2,2
2014-09-21,3,MIA,KAN,Away,332,342,191,168,1,3,141,174,0,2,0,0
2014-09-28,4,LVR,MIA,Away,317,435,264,278,2,2,53,157,0,2,3,3
2014-10-12,6,MIA,GNB,Away,349,369,237,248,2,3,112,121,1,0,3,3
2014-10-19,7,CHI,MIA,Away,224,393,172,256,1,2,52,137,1,1,0,0
2014-10-26,8,JAX,MIA,Away,377,326,201,178,1,1,176,148,0,0,1,1
2014-11-02,9,MIA,LAC,Home,441,178,309,128,3,0,132,50,1,0,0,0
2014-11-09,10,DET,MIA,Home,351,228,288,178,2,1,63,50,0,0,2,2
2014-11-13,11,MIA,BUF,Home,330,237,205,183,2,0,125,54,0,0,2,2
2014-11-23,12,DEN,MIA,Home,450,313,249,216,4,3,201,97,1,2,1,1
2014-12-01,13,NYJ,MIA,Away,326,291,49,217,0,0,277,74,1,1,1,1
2014-12-07,14,MIA,BAL,Away,249,447,186,264,1,2,63,183,0,2,0,0
2014-12-14,15,NWE,MIA,Home,395,384,287,308,2,1,108,76,2,0,2,2
2014-12-21,16,MIA,MIN,Home,493,357,383,238,4,2,110,119,1,2,2,2
2014-12-28,17,MIA,NYJ,Away,387,494,208,390,1,3,179,104,2,1,1,1
2015-09-13,1,WAS,MIA,Away,349,256,188,182,1,1,161,74,0,0,1,1
2015-09-20,2,JAX,MIA,Home,396,386,273,344,2,2,123,42,0,0,0,0
2015-09-27,3,MIA,BUF,Away,391,428,289,277,2,3,102,151,0,1,3,3
2015-10-04,4,MIA,NYJ,Away,226,425,167,218,2,1,59,207,0,2,2,2
2015-10-18,6,TEN,MIA,Away,299,434,236,254,1,2,63,180,0,2,2,2
2015-10-25,7,MIA,HOU,Home,503,322,255,251,4,3,248,71,1,1,1,1
2015-10-29,8,NWE,MIA,Home,437,270,342,255,4,0,95,15,0,1,2,2
2015-11-08,9,BUF,MIA,Home,420,397,154,289,1,0,266,108,3,2,1,1
2015-11-15,10,PHI,MIA,Away,436,289,353,190,1,2,83,99,1,0,0,0
2015-11-22,11,MIA,DAL,Away,210,386,140,220,2,2,70,166,0,0,1,1
2015-11-29,12,NYJ,MIA,Home,411,333,274,321,4,3,137,12,1,0,2,2
2015-12-06,13,MIA,BAL,Home,219,375,82,281,1,1,137,94,0,0,1,1
2015-12-14,14,MIA,NYG,Away,363,429,235,337,1,4,128,92,2,0,1,1
2015-12-20,15,LAC,MIA,Home,442,231,302,187,3,0,140,44,1,2,1,1
2015-12-27,16,MIA,IND,Away,361,268,279,168,0,0,82,100,1,2,1,1
2016-01-03,17,MIA,NWE,Home,438,196,342,126,2,0,96,70,0,1,0,0
2016-09-11,1,SEA,MIA,Home,352,214,240,150,1,0,112,64,0,1,0,0
2016-09-18,2,NWE,MIA,Home,463,457,302,387,3,2,161,70,1,1,4,4
2016-09-25,3,MIA,CLE,Home,426,430,311,261,3,0,115,169,1,1,3,3
2016-09-29,4,CIN,MIA,Home,362,222,285,160,1,1,77,62,0,0,2,2
2016-10-09,5,MIA,TEN,Away,200,398,149,163,0,3,51,235,1,1,2,2
2016-10-16,6,MIA,PIT,Home,474,297,252,169,0,1,222,128,3,1,0,0
2016-10-23,7,MIA,BUF,Home,454,267,198,200,1,1,256,67,2,2,0,0
2016-11-06,9,MIA,NYJ,Home,274,331,137,191,1,1,137,140,1,1,0,0
2016-11-13,10,LAC,MIA,Away,379,337,309,231,3,2,70,106,0,1,1,1
2016-11-20,11,LAR,MIA,Away,227,240,125,142,0,2,102,98,1,0,1,1
2016-11-27,12,MIA,SFO,Home,358,475,263,282,3,3,95,193,1,0,0,0
2016-12-04,13,BAL,MIA,Home,496,277,386,215,4,1,110,62,1,0,3,3
2016-12-11,14,MIA,ARI,Home,314,300,231,125,3,2,83,175,0,1,3,3
2016-12-17,15,NYJ,MIA,Away,360,303,244,236,1,4,116,67,0,0,1,1
2016-12-24,16,BUF,MIA,Away,589,494,317,233,3,2,272,261,1,2,1,1
2017-01-01,17,MIA,NWE,Away,280,396,205,276,2,3,75,120,0,1,2,2
2017-09-17,2,LAC,MIA,Away,367,336,323,225,1,1,44,111,1,0,0,0
2017-09-24,3,NYJ,MIA,Home,336,225,233,195,1,1,103,30,1,0,2,2
2017-10-01,4,MIA,NOR,Away,186,347,128,261,0,2,58,86,0,0,1,1
2017-10-08,5,MIA,TEN,Home,178,188,78,119,1,1,100,69,0,0,2,2
2017-10-15,6,ATL,MIA,Away,339,289,239,151,1,2,100,138,1,0,1,1
2017-10-22,7,MIA,NYJ,Home,357,272,304,180,4,3,53,92,0,1,2,2
2017-10-26,8,BAL,MIA,Home,295,196,121,151,2,0,174,45,0,0,2,2
2017-11-05,9,MIA,LVR,Away,395,379,309,295,3,1,86,84,0,2,1,1
2017-11-13,10,CAR,MIA,Home,548,313,254,213,4,2,294,100,2,1,1,1
2017-11-19,11,MIA,TAM,Away,448,321,365,268,2,2,83,53,0,0,5,5
2017-11-26,12,NWE,MIA,Home,417,221,221,154,4,1,196,67,1,0,3,3
2017-12-03,13,MIA,DEN,Home,367,270,222,167,2,0,145,103,1,0,3,3
2017-12-11,14,MIA,NWE,Home,362,248,242,223,3,1,120,25,0,1,0,0
2017-12-17,15,BUF,MIA,Home,328,349,212,249,1,0,116,100,2,1,3,3
2017-12-24,16,KAN,MIA,Home,404,345,301,286,1,1,103,59,1,0,2,2
2017-12-31,17,MIA,BUF,Away,356,312,263,186,1,1,93,126,1,1,1,1
2018-09-09,1,MIA,TEN,Home,342,336,222,220,2,0,120,116,0,1,2,2
2018-09-16,2,NYJ,MIA,Away,362,257,320,122,1,2,42,135,0,1,2,2
2018-09-23,3,MIA,LVR,Home,373,434,332,325,4,1,41,109,0,1,0,0
2018-09-30,4,NWE,MIA,Home,449,172,274,116,3,1,175,56,2,0,2,2
2018-10-07,5,CIN,MIA,Home,332,297,229,169,1,1,103,128,0,0,3,3
2018-10-14,6,MIA,CHI,Home,541,467,380,303,3,3,161,164,0,1,3,3
2018-10-21,7,MIA,DET,Away,322,457,215,209,2,2,107,248,1,1,0,0
2018-10-25,8,HOU,MIA,Home,427,370,239,254,5,1,188,116,1,1,1,1
2018-11-04,9,MIA,NYJ,Home,168,282,104,202,0,0,64,80,0,0,0,0
2018-11-11,10,GNB,MIA,Home,377,294,182,163,2,0,195,131,2,0,2,2
2018-11-25,12,IND,MIA,Home,455,314,337,201,3,2,118,113,0,1,1,1
2018-12-02,13,MIA,BUF,Home,175,415,115,217,3,2,60,198,0,0,1,1
2018-12-09,14,MIA,NWE,Home,412,421,223,344,3,3,189,77,2,1,0,0
2018-12-16,15,MIN,MIA,Home,418,193,198,37,2,0,220,156,3,1,0,0
2018-12-23,16,MIA,JAX,Away,183,244,121,118,1,0,62,126,0,1,2,2
2018-12-30,17,BUF,MIA,Home,381,225,215,126,3,1,166,99,3,0,4,4
2019-09-08,1,MIA,BAL,Away,200,643,179,378,1,6,21,265,0,2,3,3
2019-09-15,2,MIA,NWE,Away,184,379,142,255,0,2,42,124,0,2,4,4
2019-09-22,3,DAL,MIA,Home,476,283,241,211,2,0,235,72,2,0,1,1
2019-09-29,4,MIA,LAC,Away,233,390,161,311,1,2,72,79,0,1,1,1
2019-10-13,6,MIA,WAS,Away,271,311,187,166,1,2,84,145,1,0,2,2
2019-10-20,7,BUF,MIA,Home,305,381,188,272,2,1,117,109,0,2,2,2
2019-10-28,8,PIT,MIA,Home,394,230,236,170,2,2,158,60,1,0,4,4
2019-11-03,9,MIA,NYJ,Home,316,321,266,238,3,1,50,83,0,0,0,0
2019-11-10,10,IND,MIA,Away,300,229,191,159,1,0,109,70,0,1,2,2
2019-11-17,11,MIA,BUF,Away,303,424,280,256,0,3,23,168,2,1,1,1
2019-11-24,12,CLE,MIA,Home,467,284,320,192,3,2,147,92,2,1,2,2
2019-12-01,13,MIA,PHI,Home,409,386,351,294,4,3,58,92,1,0,1,1
2019-12-08,14,NYJ,MIA,Home,374,362,262,240,2,0,112,122,0,0,1,1
2019-12-15,15,NYG,MIA,Home,412,384,274,262,2,2,138,122,3,0,1,1
2019-12-22,16,MIA,CIN,Home,502,430,406,371,4,4,96,59,1,0,1,1
2019-12-29,17,NWE,MIA,Away,352,389,217,326,2,1,135,63,1,1,0,0
2020-09-13,1,NWE,MIA,Home,357,269,140,182,0,0,217,87,3,1,3,3
2020-09-20,2,MIA,BUF,Away,410,523,311,411,2,4,99,112,1,0,0,0
2020-09-24,3,JAX,MIA,Away,318,294,246,156,0,2,72,138,2,2,0,0
2020-10-04,4,MIA,SEA,Away,415,441,312,343,0,2,103,98,1,2,2,2
2020-10-11,5,SFO,MIA,Away,259,436,128,342,1,3,131,94,1,1,0,0
2020-10-18,6,MIA,NYJ,Home,302,263,192,148,3,0,110,115,0,0,2,2
2020-11-01,8,MIA,LAR,Home,145,471,90,340,1,1,55,131,1,1,2,2
2020-11-08,9,ARI,MIA,Away,442,312,264,221,3,2,178,91,1,1,0,0
2020-11-15,10,MIA,LAC,Home,280,273,169,174,2,2,111,99,1,1,1,1
2020-11-22,11,DEN,MIA,Home,459,223,270,167,0,1,189,56,2,0,1,1
2020-11-29,12,NYJ,MIA,Away,260,345,173,241,0,2,87,104,0,0,2,2
2020-12-06,13,MIA,CIN,Home,406,196,296,156,1,1,110,40,0,0,1,1
2020-12-13,14,MIA,KAN,Away,367,448,287,354,2,2,80,94,1,1,1,1
2020-12-20,15,MIA,NWE,Home,383,303,133,186,0,0,250,117,3,0,1,1
2020-12-26,16,LVR,MIA,Away,418,383,314,253,1,2,104,130,1,0,0,0
2021-01-03,17,BUF,MIA,Home,455,454,377,384,4,1,78,70,2,2,4,4
2021-09-12,1,NWE,MIA,Away,393,259,268,185,1,1,125,74,0,1,1,1
2021-09-19,2,MIA,BUF,Away,216,314,145,171,0,2,71,143,0,3,3,3
2021-09-26,3,LVR,MIA,Home,497,330,357,197,2,0,140,133,1,2,0,0
2021-10-03,4,MIA,IND,Away,203,349,168,210,2,2,35,139,0,1,2,2
2021-10-10,5,TAM,MIA,Home,558,301,437,262,5,2,121,39,1,0,2,2
2021-10-17,6,JAX,MIA,Home,396,431,312,354,1,2,84,77,1,0,1,1
2021-10-24,7,MIA,ATL,Away,413,397,281,325,4,2,132,72,0,1,2,2
2021-10-31,8,BUF,MIA,Home,351,262,249,194,2,0,102,68,1,1,2,2
2021-11-07,9,MIA,HOU,Home,262,272,215,199,1,0,47,73,1,0,5,5
2021-11-11,10,MIA,BAL,Home,350,304,290,210,0,1,60,94,1,0,0,0
2021-11-21,11,NYJ,MIA,Away,380,388,278,273,2,2,102,115,0,1,1,1
2021-11-28,12,MIA,CAR,Home,315,198,204,134,1,0,111,64,2,1,1,1
2021-12-05,13,MIA,NYG,Home,297,250,229,159,2,0,68,91,0,0,0,0
2021-12-19,15,MIA,NYJ,Home,379,228,196,126,2,0,183,102,2,2,3,3
2021-12-27,16,NOR,MIA,Away,164,259,81,173,0,1,83,86,0,0,1,1
2022-01-02,17,TEN,MIA,Home,308,256,110,182,2,0,198,74,2,0,2,2
2022-01-09,18,MIA,NWE,Home,298,379,103,245,1,1,195,134,1,2,0,0
2022-09-11,1,MIA,NWE,Home,307,271,242,193,1,1,65,78,0,0,0,0
2022-09-18,2,BAL,MIA,Away,473,547,318,461,3,6,155,86,1,0,2,2
2022-09-25,3,MIA,BUF,Home,212,497,171,382,1,2,41,115,2,0,0,0
2022-09-29,4,CIN,MIA,Home,371,378,304,293,2,1,67,85,1,0,2,2
2022-10-09,5,NYJ,MIA,Home,322,295,187,158,0,0,135,137,5,2,2,2
2022-10-16,6,MIA,MIN,Away,458,234,385,156,2,2,73,78,0,1,3,3
2022-10-23,7,MIA,PIT,Home,372,341,261,246,1,1,111,95,0,0,0,0
2022-10-30,8,DET,MIA,Away,393,476,311,369,1,3,82,107,2,1,1,1
2022-11-06,9,CHI,MIA,Away,368,379,116,302,3,3,252,77,1,1,0,0
2022-11-13,10,MIA,CLE,Home,491,297,296,185,3,1,195,112,2,1,0,0
2022-11-27,12,MIA,HOU,Home,339,210,273,174,1,1,66,36,1,1,1,1
2022-12-04,13,SFO,MIA,Home,351,308,230,275,2,2,121,33,0,0,4,4
2022-12-11,14,LAC,MIA,Home,432,219,350,127,1,1,82,92,1,0,0,0
2022-12-17,15,BUF,MIA,Home,446,405,296,217,4,2,150,188,0,1,0,0
2022-12-25,16,MIA,GNB,Away,376,301,294,222,1,1,82,79,1,1,4,4
2023-01-01,17,NWE,MIA,Home,249,333,173,247,2,2,76,86,0,1,2,2
2023-01-08,18,MIA,NYJ,Home,302,187,140,149,0,0,162,38,0,0,0,0
2023-09-10,1,LAC,MIA,Away,433,536,200,466,1,3,233,70,3,1,2,2
2023-09-17,2,NWE,MIA,Away,288,389,200,244,1,1,88,145,1,2,1,1
2023-09-24,3,MIA,DEN,Home,726,363,376,294,5,1,350,69,5,0,0,0
2023-10-01,4,BUF,MIA,Home,414,393,310,251,4,1,104,142,2,2,2,2
2023-10-08,5,MIA,NYG,Home,524,268,302,183,2,0,222,85,2,0,3,3
2023-10-15,6,MIA,CAR,Home,424,296,262,188,3,1,162,108,3,1,1,1
2023-10-22,7,PHI,MIA,Home,355,244,256,199,2,1,99,45,2,0,1,1
2023-10-29,8,MIA,NWE,Home,390,218,312,141,3,2,78,77,1,0,2,2
2023-11-05,9,KAN,MIA,Home,267,292,174,175,2,1,93,117,0,1,1,1
2023-11-19,11,MIA,LVR,Home,422,296,323,260,2,1,99,36,0,0,3,3
2023-11-24,12,NYJ,MIA,Away,159,395,130,228,1,1,29,167,0,2,3,3
2023-12-03,13,WAS,MIA,Away,245,406,107,283,0,2,138,123,2,3,0,0
2023-12-11,14,MIA,TEN,Away,366,403,208,320,0,1,158,83,2,2,1,1
2023-12-17,15,MIA,NYJ,Home,290,103,213,80,1,0,77,23,2,0,0,0
2023-12-24,16,MIA,DAL,Home,375,339,284,242,1,2,91,97,0,0,0,0
2023-12-31,17,BAL,MIA,Home,491,375,331,221,6,2,160,154,2,0,3,3
2024-01-07,18,MIA,BUF,Away,275,473,167,345,1,2,108,128,1,0,2,2
2014-09-07,1,LAR,MIN,Away,318,355,246,170,0,2,72,185,0,1,0,0
2014-09-14,2,MIN,NWE,Away,217,292,163,142,1,1,54,150,0,1,4,4
2014-09-21,3,NOR,MIN,Home,396,247,288,188,2,0,108,59,1,0,0,0
2014-09-28,4,MIN,ATL,Home,558,411,317,288,0,3,241,123,4,1,0,0
2014-10-02,5,GNB,MIN,Home,320,299,164,188,3,0,156,111,2,1,3,3
2014-10-12,6,MIN,DET,Away,212,255,143,155,0,1,69,100,0,1,3,3
2014-10-19,7,BUF,MIN,Home,373,276,255,118,2,1,118,158,0,0,2,2
2014-10-26,8,TAM,MIN,Away,225,332,159,235,1,1,66,97,0,0,0,0
2014-11-02,9,MIN,WAS,Home,352,347,252,225,1,1,100,122,3,2,0,0
2014-11-16,11,CHI,MIN,Home,468,243,330,147,3,1,138,96,0,0,1,1
2014-11-23,12,MIN,GNB,Away,308,362,196,207,2,2,112,155,0,1,1,1
2014-11-30,13,MIN,CAR,Home,210,348,118,170,2,1,92,178,0,0,0,0
2014-12-07,14,MIN,NYJ,Home,411,410,297,242,2,1,114,168,0,0,2,2
2014-12-14,15,DET,MIN,Home,233,360,153,284,1,1,80,76,0,1,2,2
2014-12-21,16,MIA,MIN,Home,493,357,383,238,4,2,110,119,1,2,1,1
2014-12-28,17,MIN,CHI,Home,311,264,190,165,1,0,121,99,0,0,1,1
2015-09-14,1,SFO,MIN,Home,395,248,165,177,0,0,230,71,2,0,1,1
2015-09-20,2,MIN,DET,Home,350,323,151,285,1,2,199,38,2,0,1,1
2015-09-27,3,MIN,LAC,Home,284,369,121,279,0,2,163,90,3,0,1,1
2015-10-04,4,DEN,MIN,Home,344,325,200,212,1,1,144,113,1,1,1,1
2015-10-18,6,MIN,KAN,Home,321,328,237,271,1,1,84,57,0,0,2,2
2015-10-25,7,DET,MIN,Away,274,425,197,285,2,2,77,140,0,0,1,1
2015-11-01,8,CHI,MIN,Away,305,327,208,180,1,1,97,147,1,0,1,1
2015-11-08,9,MIN,LAR,Home,293,320,148,160,0,0,145,160,2,1,1,1
2015-11-15,10,LVR,MIN,Away,371,385,287,122,2,1,84,263,0,1,0,0
2015-11-22,11,MIN,GNB,Away,342,320,248,196,1,2,94,124,1,0,1,1
2015-11-29,12,ATL,MIN,Away,326,365,210,174,1,0,116,191,0,2,1,1
2015-12-06,13,MIN,SEA,Away,125,433,94,260,0,3,31,173,0,2,1,1
2015-12-10,14,ARI,MIN,Home,393,389,296,317,2,1,97,72,0,1,3,3
2015-12-20,15,MIN,CHI,Home,350,293,221,199,4,2,129,94,1,0,0,0
2015-12-27,16,MIN,NYG,Home,368,363,150,272,1,2,218,91,3,0,0,0
2016-01-03,17,GNB,MIN,Away,350,242,274,91,1,0,76,151,0,1,2,2
2016-09-11,1,TEN,MIN,Away,316,301,252,236,2,0,64,65,0,0,0,0
2016-09-18,2,MIN,GNB,Home,284,263,254,180,2,1,30,83,0,1,1,1
2016-09-25,3,CAR,MIN,Away,306,211,201,153,0,1,105,58,1,0,0,0
2016-10-03,4,MIN,NYG,Home,366,339,262,261,1,0,104,78,2,1,0,0
2016-10-09,5,MIN,HOU,Home,351,214,255,155,2,1,96,59,1,0,0,0
2016-10-23,7,PHI,MIN,Home,239,282,138,189,1,1,101,93,0,0,4,4
2016-10-31,8,CHI,MIN,Home,403,258,245,201,1,1,158,57,1,0,0,0
2016-11-06,9,MIN,DET,Away,337,311,259,214,1,2,78,97,1,0,0,0
2016-11-13,10,WAS,MIN,Home,388,331,260,284,2,2,128,47,0,1,1,1
2016-11-20,11,MIN,ARI,Home,217,290,145,155,1,2,72,135,1,1,1,1
2016-11-24,12,DET,MIN,Home,308,306,214,224,1,0,94,82,0,1,1,1
2016-12-01,13,MIN,DAL,Away,318,264,231,124,1,1,87,140,0,1,1,1
2016-12-11,14,JAX,MIN,Away,315,377,230,292,1,1,85,85,0,1,1,1
2016-12-18,15,MIN,IND,Away,282,411,248,250,0,2,34,161,0,2,3,3
2016-12-24,16,GNB,MIN,Home,348,446,308,353,4,3,40,93,1,0,2,2
2017-01-01,17,MIN,CHI,Home,374,323,250,140,3,1,124,183,1,0,1,1
2017-09-11,1,MIN,NOR,Home,470,344,341,284,3,1,129,60,0,0,0,0
2017-09-17,2,PIT,MIN,Home,335,237,233,146,2,0,102,91,0,1,1,1
2017-09-24,3,MIN,TAM,Home,494,342,369,316,3,2,125,26,1,0,0,0
2017-10-01,4,MIN,DET,Away,284,251,197,154,0,0,87,97,1,1,3,3
2017-10-09,5,CHI,MIN,Away,274,300,159,141,2,1,115,159,0,1,0,0
2017-10-15,6,MIN,GNB,Home,351,227,239,155,1,1,112,72,1,0,2,2
2017-10-22,7,MIN,BAL,Home,357,208,188,144,0,1,169,64,1,0,1,1
2017-10-29,8,CLE,MIN,Away,276,375,161,287,0,2,115,88,2,1,1,1
2017-11-12,10,WAS,MIN,Away,394,406,313,304,1,4,81,102,2,1,2,2
2017-11-19,11,MIN,LAR,Home,451,254,280,209,1,0,171,45,2,1,0,0
2017-11-23,12,DET,MIN,Away,289,408,236,272,2,2,53,136,0,2,0,0
2017-12-03,13,ATL,MIN,Away,275,312,173,207,0,2,102,105,0,0,0,0
2017-12-10,14,CAR,MIN,Home,345,356,129,256,1,2,216,100,3,0,3,3
2017-12-17,15,MIN,CIN,Home,346,161,222,115,2,0,124,46,1,1,1,1
2017-12-23,16,GNB,MIN,Away,239,236,126,124,0,1,113,112,0,0,0,0
2017-12-31,17,MIN,CHI,Home,327,201,180,171,1,0,147,30,2,0,0,0
2018-09-09,1,MIN,SFO,Home,343,327,227,237,2,1,116,90,0,0,1,1
2018-09-16,2,GNB,MIN,Home,351,480,253,412,1,4,98,68,0,0,1,1
2018-09-23,3,MIN,BUF,Away,292,292,278,164,1,1,14,128,0,2,3,3
2018-09-27,4,LAR,MIN,Home,556,446,456,392,5,3,100,54,0,0,1,1
2018-10-07,5,PHI,MIN,Away,364,375,283,298,2,1,81,77,0,0,1,1
2018-10-14,6,MIN,ARI,Home,411,268,216,208,1,0,195,60,2,1,2,2
2018-10-21,7,NYJ,MIN,Away,263,316,192,228,1,2,71,88,1,2,0,0
2018-10-28,8,MIN,NOR,Away,423,270,338,164,2,1,85,106,1,1,2,2
2018-11-04,9,MIN,DET,Home,283,209,155,143,1,0,128,66,1,0,2,2
2018-11-18,11,CHI,MIN,Home,308,268,160,246,1,2,148,22,0,0,3,3
2018-11-25,12,MIN,GNB,Home,416,254,325,172,3,1,91,82,0,1,0,0
2018-12-02,13,NWE,MIN,Home,471,278,311,183,1,1,160,95,2,0,2,2
2018-12-10,14,SEA,MIN,Home,274,276,60,199,0,1,214,77,1,0,1,1
2018-12-16,15,MIN,MIA,Home,418,193,198,37,2,0,220,156,3,1,1,1
2018-12-23,16,DET,MIN,Away,223,340,137,240,0,3,86,100,0,0,0,0
2018-12-30,17,MIN,CHI,Away,164,332,101,163,1,0,63,169,0,3,0,0
2019-09-08,1,MIN,ATL,Home,269,345,97,272,1,2,172,73,3,0,0,0
2019-09-15,2,GNB,MIN,Home,335,421,191,223,2,1,144,198,1,1,4,4
2019-09-22,3,MIN,LVR,Home,385,302,174,214,1,2,211,88,3,0,0,0
2019-09-29,4,CHI,MIN,Home,269,222,197,182,1,0,72,40,0,1,2,2
2019-10-06,5,NYG,MIN,Away,211,490,147,279,1,2,64,211,0,0,1,1
2019-10-13,6,MIN,PHI,Home,447,400,325,292,4,2,122,108,1,0,2,2
2019-10-20,7,DET,MIN,Away,433,504,352,338,4,4,81,166,0,2,0,0
2019-10-24,8,MIN,WAS,Home,434,216,273,131,0,0,161,85,1,0,1,1
2019-11-03,9,KAN,MIN,Home,377,308,230,212,1,3,147,96,1,0,0,0
2019-11-10,10,DAL,MIN,Away,443,364,393,211,3,2,50,153,0,1,0,0
2019-11-17,11,MIN,DEN,Home,321,394,284,270,3,1,37,124,1,1,2,2
2019-12-02,13,SEA,MIN,Home,444,354,226,276,2,2,218,78,2,1,3,3
2019-12-08,14,MIN,DET,Home,354,231,234,161,1,1,120,70,1,0,0,0
2019-12-15,15,LAC,MIN,Away,345,344,283,207,1,1,62,137,0,2,1,1
2019-12-23,16,MIN,GNB,Away,139,383,82,199,1,0,57,184,0,2,1,1
2019-12-29,17,MIN,CHI,Away,300,337,126,179,0,0,174,158,1,1,3,3
2020-09-13,1,MIN,GNB,Away,382,522,248,364,2,4,134,158,2,1,1,1
2020-09-20,2,IND,MIN,Home,354,175,203,95,1,0,151,80,1,1,3,3
2020-09-27,3,MIN,TEN,Away,464,444,238,310,3,0,226,134,1,2,3,3
2020-10-04,4,HOU,MIN,Away,386,410,290,248,2,1,96,162,0,3,0,0
2020-10-11,5,SEA,MIN,Home,314,449,190,248,3,2,124,201,1,1,2,2
2020-10-18,6,MIN,ATL,Away,365,462,333,363,3,4,32,99,0,0,3,3
2020-11-01,8,GNB,MIN,Away,400,324,291,151,3,1,109,173,0,3,0,0
2020-11-08,9,MIN,DET,Home,487,421,212,292,3,2,275,129,2,0,0,0
2020-11-16,10,CHI,MIN,Away,149,385,108,286,0,2,41,99,0,0,2,2
2020-11-22,11,MIN,DAL,Away,430,376,305,196,3,3,125,180,1,1,2,2
2020-11-29,12,MIN,CAR,Home,387,374,291,267,3,1,96,107,0,0,3,3
2020-12-06,13,MIN,JAX,Home,420,390,275,266,3,1,145,124,0,1,2,2
2020-12-13,14,TAM,MIN,Home,303,335,196,173,2,1,107,162,1,1,1,1
2020-12-20,15,MIN,CHI,Away,407,397,249,198,2,1,158,199,1,2,1,1
2020-12-25,16,NOR,MIN,Home,583,364,319,274,0,3,264,90,7,2,0,0
2021-01-03,17,DET,MIN,Away,417,508,288,383,3,3,129,125,2,2,0,0
2021-09-12,1,CIN,MIN,Home,366,403,217,336,2,2,149,67,1,1,1,1
2021-09-19,2,ARI,MIN,Home,474,419,371,242,3,3,103,177,1,0,0,0
2021-09-26,3,MIN,SEA,Home,453,389,313,283,3,1,140,106,0,1,0,0
2021-10-03,4,MIN,CLE,Away,255,327,190,143,1,0,65,184,0,1,1,1
2021-10-10,5,MIN,DET,Home,384,288,264,180,1,0,120,108,0,1,2,2
2021-10-17,6,CAR,MIN,Away,306,571,188,373,1,3,118,198,1,1,1,1
2021-10-31,8,MIN,DAL,Away,278,419,177,341,1,2,101,78,0,0,0,0
2021-11-07,9,BAL,MIN,Home,500,318,253,187,3,2,247,131,1,1,0,0
2021-11-14,10,LAC,MIN,Away,253,381,171,278,1,2,82,103,1,1,1,1
2021-11-21,11,MIN,GNB,Home,408,467,318,372,3,4,90,95,1,0,0,0
2021-11-28,12,SFO,MIN,Home,423,323,215,256,1,2,208,67,3,1,2,2
2021-12-05,13,DET,MIN,Home,372,426,272,326,3,2,100,100,0,1,1,1
2021-12-09,14,MIN,PIT,Home,458,375,216,269,2,3,242,106,2,1,2,2
2021-12-20,15,CHI,MIN,Away,370,193,255,61,1,2,115,132,0,0,1,1
2021-12-26,16,MIN,LAR,Away,361,356,295,197,1,1,66,159,1,1,1,1
2022-01-02,17,GNB,MIN,Home,481,206,307,179,2,1,174,27,2,0,0,0
2022-01-09,18,MIN,CHI,Home,331,356,227,266,3,1,104,90,0,0,0,0
2022-09-11,1,MIN,GNB,Home,395,338,269,227,2,0,126,111,0,1,0,0
2022-09-19,2,PHI,MIN,Home,486,264,323,202,1,1,163,62,2,0,3,3
2022-09-25,3,MIN,DET,Home,373,416,250,277,2,1,123,139,2,2,1,1
2022-10-02,4,NOR,MIN,Away,338,344,227,263,1,1,111,81,2,1,1,1
2022-10-09,5,MIN,CHI,Home,429,271,312,193,1,1,117,78,3,1,1,1
2022-10-16,6,MIA,MIN,Away,458,234,385,156,2,2,73,78,0,1,0,0
2022-10-30,8,MIN,ARI,Home,381,375,208,297,2,3,173,78,3,0,1,1
2022-11-06,9,WAS,MIN,Away,263,301,126,245,2,2,137,56,0,0,1,1
2022-11-13,10,BUF,MIN,Away,486,481,311,334,1,1,175,147,2,2,2,2
2022-11-20,11,MIN,DAL,Away,183,458,110,307,0,2,73,151,0,2,1,1
2022-11-24,12,MIN,NWE,Home,358,409,301,364,3,2,57,45,0,0,1,1
2022-12-04,13,MIN,NYJ,Home,287,486,159,366,1,0,128,120,2,1,0,0
2022-12-11,14,DET,MIN,Home,464,416,330,394,3,2,134,22,1,1,2,2
2022-12-17,15,MIN,IND,Home,518,341,426,170,4,1,92,171,1,0,3,3
2022-12-24,16,MIN,NYG,Home,353,445,270,319,3,1,83,126,0,1,0,0
2023-01-01,17,GNB,MIN,Home,315,346,152,244,1,2,163,102,2,0,4,4
2023-01-08,18,CHI,MIN,Away,259,482,141,341,1,1,118,141,1,2,2,2
2023-09-10,1,MIN,TAM,Away,369,242,328,169,2,2,41,73,0,0,3,3
2023-09-14,2,PHI,MIN,Home,430,374,171,346,1,4,259,28,3,0,4,4
2023-09-24,3,MIN,LAC,Away,475,475,345,445,3,4,130,30,0,0,2,2
2023-10-01,4,CAR,MIN,Away,232,265,149,130,0,2,83,135,0,0,2,2
2023-10-08,5,MIN,KAN,Away,329,333,259,266,2,2,70,67,0,1,1,1
2023-10-15,6,CHI,MIN,Away,275,220,113,174,0,1,162,46,1,0,1,1
2023-10-23,7,MIN,SFO,Home,452,325,378,260,2,1,74,65,0,1,1,1
2023-10-29,8,GNB,MIN,Away,270,346,196,284,1,2,74,62,0,1,1,1
2023-11-05,9,ATL,MIN,Away,370,363,260,217,1,2,110,146,1,1,2,2
2023-11-12,10,MIN,NOR,Home,388,280,263,215,1,2,125,65,2,0,0,0
2023-11-19,11,DEN,MIN,Home,295,385,249,210,1,1,46,175,0,1,3,3
2023-11-27,12,MIN,CHI,Away,242,317,169,199,1,0,73,118,0,0,4,4
2023-12-10,14,LVR,MIN,Away,202,231,146,99,0,0,56,132,0,0,0,0
2023-12-16,15,CIN,MIN,Home,378,424,298,281,2,2,80,143,1,1,2,2
2023-12-24,16,MIN,DET,Away,390,389,373,246,2,1,17,143,1,3,4,4
2023-12-31,17,MIN,GNB,Away,211,470,144,293,1,3,67,177,0,1,2,2
2024-01-07,18,DET,MIN,Home,381,448,311,359,2,2,70,89,2,0,2,2
2014-09-07,1,ATL,NOR,Home,568,472,445,333,3,1,123,139,1,3,2,2
2014-09-14,2,CLE,NOR,Home,324,397,202,223,1,2,122,174,1,1,2,2
2014-09-21,3,NOR,MIN,Home,396,247,288,188,2,0,108,59,1,0,0,0
2014-09-28,4,DAL,NOR,Home,445,438,255,334,3,2,190,104,2,0,3,3
2014-10-05,5,NOR,TAM,Home,511,314,371,248,2,2,140,66,2,1,3,3
2014-10-19,7,DET,NOR,Home,344,408,285,335,2,2,59,73,1,0,2,2
2014-10-26,8,NOR,GNB,Home,495,491,302,402,3,1,193,89,2,1,1,1
2014-10-30,9,CAR,NOR,Away,231,375,122,270,0,1,109,105,1,3,2,2
2014-11-09,10,NOR,SFO,Away,423,330,287,186,3,1,136,144,0,2,3,3
2014-11-16,11,NOR,CIN,Away,330,405,255,219,1,3,75,186,0,0,1,1
2014-11-24,12,NOR,BAL,Away,525,449,399,234,3,1,126,215,0,2,1,1
2014-11-30,13,PIT,NOR,Away,538,393,435,250,2,5,103,143,1,0,0,0
2014-12-07,14,NOR,CAR,Away,310,497,218,226,1,3,92,271,0,2,2,2
2014-12-15,15,CHI,NOR,Away,278,443,153,360,2,3,125,83,0,1,1,1
2014-12-21,16,NOR,ATL,Away,328,403,271,322,1,1,57,81,1,1,4,4
2014-12-28,17,TAM,NOR,Away,280,338,97,268,1,1,183,70,1,2,3,3
2015-09-13,1,ARI,NOR,Home,427,408,307,354,3,1,120,54,1,0,1,1
2015-09-20,2,NOR,TAM,Away,323,333,219,194,1,1,104,139,2,1,3,3
2015-09-27,3,CAR,NOR,Home,431,380,312,310,2,0,119,70,1,2,2,2
2015-10-04,4,NOR,DAL,Home,438,335,335,220,2,1,103,115,1,1,0,0
2015-10-11,5,PHI,NOR,Home,519,388,333,292,2,2,186,96,2,0,4,4
2015-10-15,6,NOR,ATL,Home,385,413,304,263,1,2,81,150,2,1,0,0
2015-10-25,7,IND,NOR,Away,376,449,301,266,3,1,75,183,0,3,1,1
2015-11-01,8,NOR,NYG,Home,608,416,505,329,7,6,103,87,0,0,2,2
2015-11-08,9,NOR,TEN,Away,416,483,355,371,3,4,61,112,1,0,2,2
2015-11-15,10,WAS,NOR,Home,510,350,301,192,4,2,209,158,0,0,2,2
2015-11-29,12,HOU,NOR,Home,362,268,195,218,2,0,167,50,1,0,1,1
2015-12-06,13,NOR,CAR,Away,334,497,264,322,3,5,70,175,1,1,1,1
2015-12-13,14,TAM,NOR,Away,291,388,176,301,1,2,115,87,1,1,0,0
2015-12-21,15,NOR,DET,Away,399,396,330,246,3,3,69,150,0,2,0,0
2015-12-27,16,NOR,JAX,Home,537,412,402,347,3,4,135,65,2,0,0,0
2016-01-03,17,ATL,NOR,Away,414,390,327,323,2,1,87,67,0,1,1,1
2016-09-11,1,NOR,LVR,Away,507,486,419,319,4,1,88,167,0,3,1,1
2016-09-18,2,NYG,NOR,Home,417,288,353,247,0,1,64,41,0,0,0,0
2016-09-26,3,NOR,ATL,Away,474,442,359,225,3,2,115,217,1,3,2,2
2016-10-02,4,LAC,NOR,Away,346,275,308,192,2,2,38,83,2,3,2,2
2016-10-16,6,NOR,CAR,Home,523,406,460,303,4,2,63,103,1,3,1,1
2016-10-23,7,KAN,NOR,Home,326,463,214,359,2,3,112,104,0,0,2,2
2016-10-30,8,NOR,SEA,Home,375,359,252,285,1,0,123,74,1,1,1,1
2016-11-06,9,SFO,NOR,Away,486,571,393,323,2,3,93,248,0,2,0,0
2016-11-13,10,NOR,DEN,Away,373,337,293,234,3,2,80,103,0,0,4,4
2016-11-17,11,CAR,NOR,Home,223,371,173,264,1,2,50,107,1,0,2,2
2016-11-27,12,NOR,LAR,Home,555,247,346,178,5,3,209,69,2,0,1,1
2016-12-04,13,NOR,DET,Away,369,422,319,337,0,2,50,85,1,0,3,3
2016-12-11,14,TAM,NOR,Home,270,294,166,248,0,0,104,46,1,0,3,3
2016-12-18,15,ARI,NOR,Away,425,488,309,358,2,4,116,130,3,2,1,1
2016-12-24,16,NOR,TAM,Home,417,349,294,260,1,2,123,89,2,1,0,0
2017-01-01,17,ATL,NOR,Home,465,473,323,341,4,2,142,132,1,2,1,1
2017-09-11,1,MIN,NOR,Home,470,344,341,284,3,1,129,60,0,0,0,0
2017-09-17,2,NOR,NWE,Away,429,555,348,436,2,3,81,119,0,1,0,0
2017-09-24,3,CAR,NOR,Away,288,362,156,213,0,3,132,149,1,1,0,0
2017-10-01,4,MIA,NOR,Away,186,347,128,261,0,2,58,86,0,0,0,0
2017-10-15,6,NOR,DET,Home,379,347,186,281,2,3,193,66,2,0,3,3
2017-10-22,7,GNB,NOR,Away,260,485,79,324,0,1,181,161,2,2,2,2
2017-10-29,8,NOR,CHI,Home,387,307,286,150,0,0,101,157,2,1,2,2
2017-11-05,9,NOR,TAM,Home,407,200,256,113,2,1,151,87,1,0,2,2
2017-11-12,10,BUF,NOR,Away,198,482,129,184,1,0,69,298,0,6,1,1
2017-11-19,11,NOR,WAS,Home,535,456,375,300,2,3,160,156,1,1,1,1
2017-11-26,12,LAR,NOR,Home,415,346,327,223,2,1,88,123,0,1,0,0
2017-12-03,13,NOR,CAR,Home,400,279,252,167,1,2,148,112,3,1,1,1
2017-12-07,14,ATL,NOR,Home,343,306,211,256,1,2,132,50,1,0,1,1
2017-12-17,15,NOR,NYJ,Home,412,294,281,170,2,1,131,124,2,1,3,3
2017-12-24,16,NOR,ATL,Home,315,331,229,264,1,1,86,67,1,0,1,1
2017-12-31,17,TAM,NOR,Home,455,323,345,231,1,1,110,92,2,1,1,1
2018-09-09,1,NOR,TAM,Away,475,529,432,417,3,4,43,112,2,1,2,2
2018-09-16,2,NOR,CLE,Home,275,327,213,234,2,1,62,93,0,1,2,2
2018-09-23,3,ATL,NOR,Away,407,534,359,391,5,3,48,143,0,2,0,0
2018-09-30,4,NYG,NOR,Away,299,389,234,219,1,0,65,170,1,3,0,0
2018-10-08,5,NOR,WAS,Home,447,283,349,244,3,0,98,39,3,2,1,1
2018-10-21,7,BAL,NOR,Away,351,339,274,205,2,2,77,134,1,1,1,1
2018-10-28,8,MIN,NOR,Away,423,270,338,164,2,1,85,106,1,1,1,1
2018-11-04,9,NOR,LAR,Home,487,483,346,391,4,3,141,92,2,1,1,1
2018-11-11,10,CIN,NOR,Away,284,509,174,265,1,3,110,244,1,3,0,0
2018-11-18,11,NOR,PHI,Home,546,196,373,138,4,0,173,58,2,1,0,0
2018-11-22,12,NOR,ATL,Home,312,366,162,340,4,2,150,26,0,0,1,1
2018-11-29,13,DAL,NOR,Home,308,176,209,111,1,1,99,65,0,0,1,1
2018-12-09,14,TAM,NOR,Away,279,298,174,198,2,1,105,100,0,2,2,2
2018-12-17,15,CAR,NOR,Away,247,346,149,191,1,0,98,155,0,1,2,2
2018-12-23,16,NOR,PIT,Home,370,429,313,364,1,3,57,65,3,0,1,1
2018-12-30,17,NOR,CAR,Away,294,374,110,263,1,2,184,111,1,2,1,1
2019-09-09,1,NOR,HOU,Home,510,414,362,234,2,3,148,180,1,1,1,1
2019-09-15,2,LAR,NOR,Home,380,244,265,187,1,0,115,57,2,0,1,1
2019-09-22,3,SEA,NOR,Away,514,265,406,177,2,2,108,88,2,1,1,1
2019-09-29,4,NOR,DAL,Home,266,257,149,212,0,0,117,45,0,1,1,1
2019-10-06,5,NOR,TAM,Home,457,252,345,158,4,2,112,94,0,1,1,1
2019-10-13,6,JAX,NOR,Away,226,326,151,222,0,1,75,104,0,0,0,0
2019-10-20,7,CHI,NOR,Away,252,424,235,273,2,2,17,151,0,2,0,0
2019-10-27,8,NOR,ARI,Home,510,237,373,197,3,0,137,40,1,0,1,1
2019-11-10,10,NOR,ATL,Away,310,317,258,174,0,2,52,143,0,0,0,0
2019-11-17,11,TAM,NOR,Away,334,328,298,219,2,3,36,109,0,0,0,0
2019-11-24,12,NOR,CAR,Home,418,351,300,230,3,3,118,121,1,1,1,1
2019-11-28,13,ATL,NOR,Away,348,279,259,184,2,1,89,95,0,1,0,0
2019-12-08,14,NOR,SFO,Away,465,516,349,354,5,5,116,162,1,1,1,1
2019-12-16,15,NOR,IND,Home,424,205,307,159,4,0,117,46,0,1,0,0
2019-12-22,16,TEN,NOR,Away,397,377,248,275,3,3,149,102,1,2,0,0
2019-12-29,17,CAR,NOR,Away,329,379,288,264,0,3,41,115,1,2,0,0
2020-09-13,1,NOR,TAM,Home,271,310,189,224,2,2,82,86,1,1,0,0
2020-09-21,2,LVR,NOR,Home,377,424,261,312,3,1,116,112,1,2,1,1
2020-09-27,3,NOR,GNB,Away,397,369,275,271,3,3,122,98,0,1,1,1
2020-10-04,4,DET,NOR,Away,281,392,191,228,3,2,90,164,1,3,1,1
2020-10-12,5,NOR,LAC,Home,408,350,313,239,1,4,95,111,2,0,1,1
2020-10-25,7,NOR,CAR,Home,415,283,277,246,2,2,138,37,1,1,1,1
2020-11-01,8,CHI,NOR,Away,329,394,233,272,2,2,96,122,0,0,0,0
2020-11-08,9,TAM,NOR,Away,194,420,186,282,0,4,8,138,0,1,2,2
2020-11-15,10,NOR,SFO,Home,237,281,123,232,1,1,114,49,2,0,2,2
2020-11-22,11,NOR,ATL,Home,376,248,210,196,0,0,166,52,3,0,1,1
2020-11-29,12,DEN,NOR,Away,112,292,12,63,0,0,100,229,0,4,1,1
2020-12-06,13,ATL,NOR,Away,332,424,262,217,1,2,70,207,0,1,1,1
2020-12-13,14,PHI,NOR,Home,413,358,167,262,1,2,246,96,2,1,2,2
2020-12-20,15,NOR,KAN,Away,285,411,225,232,3,3,60,179,1,1,1,1
2020-12-25,16,NOR,MIN,Home,583,364,319,274,0,3,264,90,7,2,2,2
2021-01-03,17,CAR,NOR,Away,320,347,246,191,0,3,74,156,1,1,0,0
2021-09-12,1,NOR,GNB,Home,322,229,151,186,5,0,171,43,0,0,0,0
2021-09-19,2,CAR,NOR,Home,383,128,294,80,2,0,89,48,1,1,2,2
2021-09-26,3,NWE,NOR,Away,300,252,251,110,1,2,49,142,0,1,0,0
2021-10-03,4,NOR,NYG,Away,405,485,235,402,1,2,170,83,2,1,1,1
2021-10-10,5,WAS,NOR,Away,373,369,242,271,0,4,131,98,2,1,2,2
2021-10-25,7,SEA,NOR,Away,219,304,129,210,1,1,90,94,0,0,1,1
2021-10-31,8,NOR,TAM,Home,361,421,209,350,2,4,152,71,1,0,0,0
2021-11-07,9,NOR,ATL,Away,376,366,267,332,2,2,109,34,1,1,1,1
2021-11-14,10,TEN,NOR,Home,264,373,198,287,1,2,66,86,1,1,1,1
2021-11-21,11,PHI,NOR,Home,380,323,138,214,0,3,242,109,3,1,3,3
2021-11-25,12,NOR,BUF,Away,190,361,146,248,1,4,44,113,0,0,1,1
2021-12-02,13,NOR,DAL,Away,405,377,252,231,2,1,153,146,0,1,4,4
2021-12-12,14,NYJ,NOR,Away,256,344,178,141,0,0,78,203,0,3,0,0
2021-12-19,15,TAM,NOR,Away,302,212,184,151,0,0,118,61,0,0,0,0
2021-12-27,16,NOR,MIA,Away,164,259,81,173,0,1,83,86,0,0,2,2
2022-01-02,17,NOR,CAR,Home,280,178,207,90,1,0,73,88,0,1,0,0
2022-01-09,18,ATL,NOR,Away,257,369,195,174,1,3,62,195,1,0,0,0
2022-09-11,1,ATL,NOR,Away,416,385,215,234,0,2,201,151,2,1,1,1
2022-09-18,2,NOR,TAM,Away,308,260,208,188,1,1,100,72,0,0,5,5
2022-09-25,3,CAR,NOR,Home,293,426,148,342,1,1,145,84,0,1,3,3
2022-10-02,4,NOR,MIN,Away,338,344,227,263,1,1,111,81,2,1,2,2
2022-10-09,5,NOR,SEA,Home,438,396,203,245,2,3,235,151,3,1,2,2
2022-10-16,6,NOR,CIN,Away,399,348,171,273,1,3,228,75,1,1,0,0
2022-10-20,7,ARI,NOR,Home,326,494,189,409,1,4,137,85,2,0,3,3
2022-10-30,8,NOR,LVR,Home,367,183,231,145,2,0,136,38,1,0,0,0
2022-11-07,9,NOR,BAL,Away,243,319,195,131,1,1,48,188,0,2,1,1
2022-11-13,10,PIT,NOR,Home,379,186,162,157,0,1,217,29,2,0,2,2
2022-11-20,11,NOR,LAR,Home,323,336,235,188,3,2,88,148,0,0,0,0
2022-11-27,12,SFO,NOR,Home,317,260,221,197,1,0,96,63,0,0,2,2
2022-12-05,13,TAM,NOR,Home,350,298,274,232,2,1,76,66,0,0,0,0
2022-12-18,15,NOR,ATL,Home,348,320,214,89,3,0,134,231,0,2,1,1
2022-12-24,16,CLE,NOR,Away,249,244,125,92,0,0,124,152,1,2,1,1
2023-01-01,17,PHI,NOR,Away,313,313,246,184,1,0,67,129,0,1,1,1
2023-01-08,18,NOR,CAR,Away,304,203,161,32,1,0,143,171,0,0,1,1
2023-09-10,1,NOR,TEN,Home,351,285,282,181,1,0,69,104,0,0,2,2
2023-09-18,2,CAR,NOR,Away,239,341,139,207,1,0,100,134,0,2,1,1
2023-09-24,3,GNB,NOR,Home,340,252,245,175,1,1,95,77,1,0,0,0
2023-10-01,4,NOR,TAM,Away,197,353,127,239,0,3,70,114,0,0,3,3
2023-10-08,5,NWE,NOR,Away,156,304,111,168,0,2,45,136,0,1,0,0
2023-10-15,6,HOU,NOR,Home,297,430,177,341,2,1,120,89,0,0,2,2
2023-10-19,7,NOR,JAX,Away,407,330,295,217,1,1,112,113,1,2,1,1
2023-10-29,8,IND,NOR,Away,371,511,207,350,2,2,164,161,1,3,1,1
2023-11-05,9,NOR,CHI,Home,301,368,214,212,3,2,87,156,0,0,0,0
2023-11-12,10,MIN,NOR,Home,388,280,263,215,1,2,125,65,2,0,2,2
2023-11-26,12,ATL,NOR,Home,396,444,168,296,1,0,228,148,1,0,2,2
2023-12-03,13,NOR,DET,Away,362,347,249,205,1,2,113,142,3,2,2,2
2023-12-10,14,NOR,CAR,Home,207,303,110,99,2,0,97,204,1,0,1,1
2023-12-17,15,NOR,NYG,Home,296,193,209,133,3,0,87,60,0,0,0,0
2023-12-21,16,LAR,NOR,Home,458,339,325,304,2,3,133,35,1,0,1,1
2023-12-31,17,TAM,NOR,Away,349,310,292,202,2,2,57,108,0,0,0,0
2024-01-07,18,NOR,ATL,Home,400,389,246,311,4,2,154,78,2,0,0,0
2014-09-07,1,MIA,NWE,Home,360,315,169,226,2,1,191,89,1,1,2,2
2014-09-14,2,MIN,NWE,Away,217,292,163,142,1,1,54,150,0,1,0,0
2014-09-21,3,NWE,LVR,Home,297,241,221,174,1,0,76,67,0,0,0,0
2014-09-29,4,KAN,NWE,Home,443,290,236,215,3,2,207,75,1,0,3,3
2014-10-05,5,NWE,CIN,Home,505,320,285,241,2,2,220,79,1,0,0,0
2014-10-12,6,BUF,NWE,Away,336,396,268,346,2,4,68,50,1,0,0,0
2014-10-16,7,NWE,NYJ,Home,323,423,260,205,3,1,63,218,0,1,0,0
2014-10-26,8,NWE,CHI,Home,487,384,365,231,5,3,122,153,0,0,0,0
2014-11-02,9,NWE,DEN,Home,398,472,332,429,4,2,66,43,0,1,1,1
2014-11-16,11,IND,NWE,Away,322,503,303,257,2,2,19,246,0,4,2,2
2014-11-23,12,NWE,DET,Home,439,335,349,244,2,0,90,91,2,0,1,1
2014-11-30,13,GNB,NWE,Home,478,320,348,236,2,2,130,84,0,1,0,0
2014-12-07,14,LAC,NWE,Away,216,397,163,310,1,2,53,87,0,0,2,2
2014-12-14,15,NWE,MIA,Home,395,384,287,308,2,1,108,76,2,0,1,1
2014-12-21,16,NYJ,NWE,Away,307,231,191,146,1,1,116,85,0,1,1,1
2014-12-28,17,NWE,BUF,Away,260,268,144,164,0,1,116,104,0,1,0,0
2015-09-10,1,NWE,PIT,Home,361,464,281,330,4,1,80,134,0,1,0,0
2015-09-20,2,BUF,NWE,Away,349,507,189,451,3,3,160,56,2,1,2,2
2015-09-27,3,NWE,JAX,Home,471,293,346,236,2,2,125,57,4,0,0,0
2015-10-11,5,DAL,NWE,Away,289,356,187,247,0,2,102,109,0,1,0,0
2015-10-18,6,IND,NWE,Away,409,417,289,301,3,3,120,116,0,1,1,1
2015-10-25,7,NWE,NYJ,Home,353,372,337,283,2,2,16,89,1,0,0,0
2015-10-29,8,NWE,MIA,Home,437,270,342,255,4,0,95,15,0,1,0,0
2015-11-08,9,NWE,WAS,Home,460,250,299,213,2,1,161,37,1,0,2,2
2015-11-15,10,NYG,NWE,Away,422,406,342,329,2,2,80,77,0,1,2,2
2015-11-23,11,NWE,BUF,Home,356,319,271,225,1,0,85,94,1,1,1,1
2015-11-29,12,DEN,NWE,Home,433,301,254,262,1,3,179,39,3,0,1,1
2015-12-06,13,NWE,PHI,Away,427,248,324,120,3,2,103,128,1,0,2,2
2015-12-13,14,HOU,NWE,Away,189,313,102,197,0,2,87,116,0,1,1,1
2015-12-20,15,NWE,TEN,Home,346,282,253,223,2,2,93,59,0,0,1,1
2015-12-27,16,NYJ,NWE,Home,428,284,285,221,3,1,143,63,0,0,1,1
2016-01-03,17,MIA,NWE,Home,438,196,342,126,2,0,96,70,0,1,0,0
2016-09-11,1,ARI,NWE,Away,344,363,252,257,2,1,92,106,1,1,2,2
2016-09-18,2,NWE,MIA,Home,463,457,302,387,3,2,161,70,1,1,1,1
2016-09-22,3,NWE,HOU,Home,282,284,97,175,0,0,185,109,3,0,0,0
2016-10-02,4,NWE,BUF,Away,277,378,187,244,0,1,90,134,0,0,1,1
2016-10-09,5,CLE,NWE,Away,262,501,235,403,2,3,27,98,0,1,0,0
2016-10-16,6,NWE,CIN,Home,437,357,358,237,3,1,79,120,1,1,0,0
2016-10-23,7,PIT,NWE,Away,375,362,281,222,1,2,94,140,0,2,2,2
2016-10-30,8,BUF,NWE,Away,376,357,209,285,0,4,167,72,3,1,0,0
2016-11-13,10,NWE,SEA,Away,385,420,304,324,0,3,81,96,3,0,2,2
2016-11-20,11,SFO,NWE,Away,299,444,177,273,2,4,122,171,0,0,0,0
2016-11-27,12,NYJ,NWE,Away,333,377,269,286,2,2,64,91,0,0,0,0
2016-12-04,13,NWE,LAR,Home,402,162,269,126,1,1,133,36,1,0,0,0
2016-12-12,14,NWE,BAL,Home,496,348,401,306,3,2,95,42,1,0,3,3
2016-12-18,15,DEN,NWE,Away,309,313,251,177,0,0,58,136,0,1,0,0
2016-12-24,16,NWE,NYJ,Home,325,239,211,128,3,0,114,111,2,0,0,0
2017-01-01,17,MIA,NWE,Away,280,396,205,276,2,3,75,120,0,1,0,0
2017-09-07,1,NWE,KAN,Away,371,537,247,352,0,4,124,185,3,2,0,0
2017-09-17,2,NOR,NWE,Away,429,555,348,436,2,3,81,119,0,1,0,0
2017-09-24,3,NWE,HOU,Home,396,417,337,292,5,2,59,125,0,0,1,1
2017-10-01,4,NWE,CAR,Away,373,444,293,304,2,3,80,140,1,1,0,0
2017-10-05,5,TAM,NWE,Away,409,402,319,289,1,1,90,113,1,0,2,2
2017-10-15,6,NYJ,NWE,Away,408,375,334,257,2,2,74,118,0,1,2,2
2017-10-22,7,NWE,ATL,Home,403,343,241,223,2,1,162,120,0,0,0,0
2017-10-29,8,NWE,LAC,Home,414,349,317,192,1,1,97,157,0,1,0,0
2017-11-12,10,DEN,NWE,Away,339,396,221,297,1,3,118,99,0,1,0,0
2017-11-19,11,LVR,NWE,Away,344,421,235,332,1,3,109,89,0,0,0,0
2017-11-26,12,NWE,MIA,Home,417,221,221,154,4,1,196,67,1,0,2,2
2017-12-03,13,BUF,NWE,Away,268,435,85,244,0,0,183,191,0,2,1,1
2017-12-11,14,MIA,NWE,Home,362,248,242,223,3,1,120,25,0,1,2,2
2017-12-17,15,PIT,NWE,Away,413,360,270,283,2,1,143,77,1,2,1,1
2017-12-24,16,NWE,BUF,Home,411,326,218,242,2,0,193,84,2,0,1,1
2017-12-31,17,NWE,NYJ,Home,330,247,183,207,2,0,147,40,1,0,0,0
2018-09-09,1,NWE,HOU,Home,389,325,267,158,3,1,122,167,0,1,3,3
2018-09-16,2,JAX,NWE,Home,480,302,376,220,4,2,104,82,0,0,1,1
2018-09-23,3,DET,NWE,Home,414,209,255,120,2,1,159,89,0,0,1,1
2018-09-30,4,NWE,MIA,Home,449,172,274,116,3,1,175,56,2,0,2,2
2018-10-04,5,NWE,IND,Home,438,439,341,355,3,3,97,84,2,0,2,2
2018-10-14,6,NWE,KAN,Home,500,446,327,352,1,4,173,94,3,0,1,1
2018-10-21,7,CHI,NWE,Away,453,381,319,273,2,3,134,108,2,0,3,3
2018-10-29,8,BUF,NWE,Away,333,387,287,311,0,0,46,76,0,1,0,0
2018-11-04,9,NWE,GNB,Home,433,367,310,250,1,2,123,117,3,0,0,0
2018-11-11,10,TEN,NWE,Home,385,284,235,244,2,0,150,40,2,1,0,0
2018-11-25,12,NYJ,NWE,Away,338,498,264,283,1,2,74,215,0,1,0,0
2018-12-02,13,NWE,MIN,Home,471,278,311,183,1,1,160,95,2,0,1,1
2018-12-09,14,MIA,NWE,Home,412,421,223,344,3,3,189,77,2,1,0,0
2018-12-16,15,PIT,NWE,Home,376,368,218,272,2,1,158,96,0,0,1,1
2018-12-23,16,NWE,BUF,Home,390,289,117,217,1,1,273,72,2,0,3,3
2018-12-30,17,NWE,NYJ,Home,375,239,244,135,4,0,131,104,0,0,0,0
2019-09-08,1,NWE,PIT,Home,465,308,366,276,3,0,99,32,0,0,0,0
2019-09-15,2,MIA,NWE,Away,184,379,142,255,0,2,42,124,0,2,1,1
2019-09-22,3,NWE,NYJ,Home,381,105,313,69,2,0,68,36,2,0,2,2
2019-09-29,4,BUF,NWE,Away,375,224,240,150,0,0,135,74,1,1,1,1
2019-10-06,5,WAS,NWE,Away,223,442,78,312,0,3,145,130,1,1,1,1
2019-10-10,6,NWE,NYG,Home,427,213,313,161,0,1,114,52,3,0,2,2
2019-10-21,7,NYJ,NWE,Away,154,323,73,249,0,1,81,74,0,3,1,1
2019-10-27,8,NWE,CLE,Home,318,310,239,151,2,1,79,159,0,0,0,0
2019-11-03,9,BAL,NWE,Home,372,342,162,268,1,1,210,74,3,1,2,2
2019-11-17,11,PHI,NWE,Away,255,298,174,224,1,1,81,74,0,0,0,0
2019-11-24,12,NWE,DAL,Home,282,321,181,212,1,0,101,109,0,0,0,0
2019-12-01,13,HOU,NWE,Home,276,448,224,303,4,3,52,145,0,0,1,1
2019-12-08,14,NWE,KAN,Away,278,346,184,271,1,1,94,75,1,1,1,1
2019-12-15,15,CIN,NWE,Away,315,291,151,116,1,2,164,175,0,1,0,0
2019-12-21,16,NWE,BUF,Home,414,268,271,176,1,2,143,92,1,0,1,1
2019-12-29,17,NWE,MIA,Away,352,389,217,326,2,1,135,63,1,1,2,2
2020-09-13,1,NWE,MIA,Home,357,269,140,182,0,0,217,87,3,1,1,1
2020-09-20,2,SEA,NWE,Home,429,464,275,397,5,1,154,67,0,2,1,1
2020-09-27,3,NWE,LVR,Home,406,375,156,249,1,2,250,126,2,0,1,1
2020-10-05,4,KAN,NWE,Home,323,357,229,172,2,1,94,185,0,0,4,4
2020-10-18,6,NWE,DEN,Away,288,299,171,164,0,0,117,135,1,0,3,3
2020-10-25,7,NWE,SFO,Away,241,467,147,270,0,0,94,197,0,4,4,4
2020-11-01,8,BUF,NWE,Home,339,349,149,161,0,0,190,188,3,2,1,1
2020-11-09,9,NYJ,NWE,Away,322,433,257,274,3,0,65,159,0,3,0,0
2020-11-15,10,NWE,BAL,Home,308,357,135,242,2,2,173,115,1,0,0,0
2020-11-22,11,HOU,NWE,Home,399,435,344,349,2,1,55,86,1,1,0,0
2020-11-29,12,NWE,ARI,Home,179,298,69,160,0,0,110,138,2,2,2,2
2020-12-06,13,LAC,NWE,Away,258,291,188,126,0,2,70,165,0,2,0,0
2020-12-10,14,LAR,NWE,Home,318,220,132,113,1,0,186,107,1,0,1,1
2020-12-20,15,MIA,NWE,Home,383,303,133,186,0,0,250,117,3,0,1,1
2020-12-28,16,NWE,BUF,Away,201,474,56,344,0,4,145,130,1,1,0,0
2021-01-03,17,NWE,NYJ,Home,404,350,238,239,4,1,166,111,0,1,0,0
2021-09-12,1,NWE,MIA,Away,393,259,268,185,1,1,125,74,0,1,2,2
2021-09-19,2,NYJ,NWE,Away,336,260,184,159,0,0,152,101,0,2,0,0
2021-09-26,3,NWE,NOR,Away,300,252,251,110,1,2,49,142,0,1,3,3
2021-10-10,5,HOU,NWE,Away,360,352,293,226,3,1,67,126,0,1,2,2
2021-10-17,6,NWE,DAL,Away,335,567,215,445,2,3,120,122,2,0,2,2
2021-10-24,7,NWE,NYJ,Home,551,299,403,237,3,1,148,62,4,1,0,0
2021-10-31,8,LAC,NWE,Away,369,352,206,210,2,0,163,142,1,1,1,1
2021-11-07,9,CAR,NWE,Away,240,273,162,122,0,1,78,151,0,1,2,2
2021-11-14,10,NWE,CLE,Home,452,217,268,118,4,1,184,99,2,0,0,0
2021-11-18,11,ATL,NWE,Away,165,308,125,174,0,1,40,134,0,0,1,1
2021-11-28,12,NWE,TEN,Home,394,355,289,85,2,1,105,270,1,1,0,0
2021-12-06,13,BUF,NWE,Away,230,241,131,19,1,0,99,222,0,1,1,1
2021-12-18,15,IND,NWE,Home,275,365,49,284,1,2,226,81,1,0,2,2
2021-12-26,16,NWE,BUF,Away,288,428,139,314,0,3,149,114,3,1,2,2
2022-01-02,17,NWE,JAX,Home,471,253,290,173,3,1,181,80,4,0,0,0
2022-01-09,18,MIA,NWE,Home,298,379,103,245,1,1,195,134,1,2,3,3
2022-09-11,1,MIA,NWE,Home,307,271,242,193,1,1,65,78,0,0,3,3
2022-09-18,2,PIT,NWE,Away,243,376,152,252,1,1,91,124,0,1,1,1
2022-09-25,3,NWE,BAL,Away,447,394,302,206,0,4,145,188,3,1,4,4
2022-10-02,4,GNB,NWE,Home,443,271,244,104,2,1,199,167,1,1,1,1
2022-10-09,5,NWE,DET,Home,364,312,188,211,1,0,176,101,0,0,1,1
2022-10-16,6,CLE,NWE,Away,328,399,258,301,1,2,70,98,0,3,1,1
2022-10-24,7,NWE,CHI,Away,260,390,190,147,1,1,70,243,1,2,4,4
2022-10-30,8,NYJ,NWE,Away,387,288,336,161,2,1,51,127,0,0,1,1
2022-11-06,9,NWE,IND,Home,203,121,133,43,1,0,70,78,0,0,1,1
2022-11-20,11,NWE,NYJ,Home,297,103,198,44,0,0,99,59,0,0,0,0
2022-11-24,12,MIN,NWE,Home,358,409,301,364,3,2,57,45,0,0,0,0
2022-12-01,13,NWE,BUF,Away,242,355,182,223,1,2,60,132,0,1,0,0
2022-12-12,14,ARI,NWE,Away,323,328,210,225,0,0,113,103,1,2,1,1
2022-12-18,15,LVR,NWE,Home,308,318,211,112,3,0,97,206,0,1,1,1
2022-12-24,16,NWE,CIN,Away,285,442,224,369,2,3,61,73,0,0,1,1
2023-01-01,17,NWE,MIA,Home,249,333,173,247,2,2,76,86,0,1,0,0
2023-01-08,18,BUF,NWE,Home,327,341,237,234,3,3,90,107,0,0,3,3
2023-09-10,1,NWE,PHI,Away,382,251,306,154,3,1,76,97,0,0,2,2
2023-09-17,2,NWE,MIA,Away,288,389,200,244,1,1,88,145,1,2,2,2
2023-09-24,3,NYJ,NWE,Away,171,358,133,201,0,1,38,157,1,0,0,0
2023-10-01,4,DAL,NWE,Home,377,253,253,200,1,0,124,53,1,0,3,3
2023-10-08,5,NWE,NOR,Away,156,304,111,168,0,2,45,136,0,1,3,3
2023-10-15,6,LVR,NWE,Home,348,259,264,176,1,0,84,83,0,2,1,1
2023-10-22,7,NWE,BUF,Home,364,339,268,258,2,2,96,81,1,1,1,1
2023-10-29,8,MIA,NWE,Home,390,218,312,141,3,2,78,77,1,0,1,1
2023-11-05,9,NWE,WAS,Away,327,432,220,308,1,1,107,124,1,1,1,1
2023-11-12,10,NWE,IND,Away,340,264,173,194,0,0,167,70,0,1,2,2
2023-11-26,12,NYG,NWE,Home,220,283,162,136,1,0,58,147,0,1,3,3
2023-12-03,13,NWE,LAC,Away,257,241,109,212,0,0,148,29,0,0,1,1
2023-12-07,14,PIT,NWE,Away,264,303,182,222,1,3,82,81,1,0,1,1
2023-12-17,15,NWE,KAN,Away,206,326,154,283,1,3,52,43,1,0,1,1
2023-12-24,16,DEN,NWE,Away,276,289,193,230,2,2,83,59,1,0,1,1
2023-12-31,17,BUF,NWE,Home,281,294,154,191,0,0,127,103,2,2,4,4
2024-01-07,18,NWE,NYJ,Away,119,254,31,69,0,0,88,185,0,1,2,2
2014-09-08,1,DET,NYG,Home,417,197,341,144,2,1,76,53,2,1,2,2
2014-09-14,2,NYG,ARI,Away,341,266,260,142,2,0,81,124,0,1,4,4
2014-09-21,3,NYG,HOU,Home,419,411,226,292,2,1,193,119,1,1,1,1
2014-09-25,4,WAS,NYG,Away,329,449,243,295,1,4,86,154,1,2,1,1
2014-10-05,5,NYG,ATL,Home,317,397,193,307,2,1,124,90,1,1,2,2
2014-10-12,6,PHI,NYG,Home,448,254,245,168,2,0,203,86,1,0,1,1
2014-10-19,7,DAL,NYG,Home,423,352,267,248,3,3,156,104,1,0,2,2
2014-11-03,9,NYG,IND,Away,438,443,349,345,2,4,89,98,1,0,1,1
2014-11-09,10,SEA,NYG,Home,510,324,160,270,0,1,350,54,5,1,2,2
2014-11-16,11,NYG,SFO,Away,330,333,265,185,1,1,65,148,0,0,5,5
2014-11-23,12,NYG,DAL,Away,417,385,328,266,3,4,89,119,1,0,1,1
2014-11-30,13,JAX,NYG,Home,258,329,140,213,1,1,118,116,0,2,3,3
2014-12-07,14,TEN,NYG,Away,207,402,146,260,0,1,61,142,0,1,1,1
2014-12-14,15,NYG,WAS,Home,287,372,238,228,3,1,49,144,0,0,1,1
2014-12-21,16,LAR,NYG,Away,387,514,281,386,2,3,106,128,1,1,0,0
2014-12-28,17,NYG,PHI,Away,505,426,429,262,1,2,76,164,1,1,1,1
2015-09-13,1,DAL,NYG,Home,436,285,356,186,3,0,80,99,0,1,0,0
2015-09-20,2,NYG,ATL,Away,388,402,291,346,2,1,97,56,0,2,1,1
2015-09-24,3,NYG,WAS,Home,363,393,279,305,2,1,84,88,1,0,0,0
2015-10-04,4,BUF,NYG,Away,313,303,258,211,1,3,55,92,0,0,1,1
2015-10-11,5,NYG,SFO,Home,525,380,441,256,3,2,84,124,0,1,1,1
2015-10-19,6,PHI,NYG,Home,428,247,270,166,1,1,158,81,1,0,3,3
2015-10-25,7,NYG,DAL,Home,289,460,157,227,0,1,132,233,1,1,0,0
2015-11-01,8,NOR,NYG,Home,608,416,505,329,7,6,103,87,0,0,1,1
2015-11-08,9,TAM,NYG,Away,383,327,247,213,0,2,136,114,1,0,2,2
2015-11-15,10,NYG,NWE,Away,422,406,342,329,2,2,80,77,0,1,1,1
2015-11-29,12,WAS,NYG,Home,407,332,302,299,1,2,105,33,1,0,3,3
2015-12-06,13,NYG,NYJ,Away,355,463,281,373,1,2,74,90,0,0,1,1
2015-12-14,14,MIA,NYG,Away,363,429,235,337,1,4,128,92,2,0,1,1
2015-12-20,15,NYG,CAR,Away,406,480,245,309,4,5,161,171,1,0,2,2
2015-12-27,16,MIN,NYG,Home,368,363,150,272,1,2,218,91,3,0,3,3
2016-01-03,17,NYG,PHI,Away,502,435,294,315,2,2,208,120,1,2,1,1
2016-09-11,1,DAL,NYG,Away,328,316,227,203,0,3,101,113,1,0,1,1
2016-09-18,2,NYG,NOR,Home,417,288,353,247,0,1,64,41,0,0,3,3
2016-09-25,3,NYG,WAS,Away,457,403,337,313,1,2,120,90,2,0,3,3
2016-10-03,4,MIN,NYG,Home,366,339,262,261,1,0,104,78,2,1,2,2
2016-10-09,5,GNB,NYG,Home,406,221,259,178,2,1,147,43,0,0,1,1
2016-10-16,6,NYG,BAL,Home,435,391,397,293,3,0,38,98,0,2,3,3
2016-10-23,7,LAR,NYG,Away,345,232,271,196,1,0,74,36,0,1,1,1
2016-11-06,9,NYG,PHI,Home,302,443,248,347,4,0,54,96,0,2,2,2
2016-11-14,10,NYG,CIN,Home,351,264,229,186,3,1,122,78,0,1,2,2
2016-11-20,11,NYG,CHI,Home,329,315,227,222,2,1,102,93,1,1,0,0
2016-11-27,12,CLE,NYG,Away,343,296,285,192,1,3,58,104,0,0,1,1
2016-12-04,13,PIT,NYG,Home,389,234,272,178,2,2,117,56,0,0,2,2
2016-12-11,14,NYG,DAL,Home,260,260,167,152,1,1,93,108,0,0,3,3
2016-12-18,15,NYG,DET,Home,300,324,186,268,2,0,114,56,0,0,0,0
2016-12-22,16,PHI,NYG,Home,286,470,168,356,1,1,118,114,1,0,3,3
2017-01-01,17,WAS,NYG,Away,284,332,246,171,1,0,38,161,0,1,0,0
2017-09-10,1,DAL,NYG,Home,392,233,263,198,1,0,129,35,0,0,1,1
2017-09-18,2,NYG,DET,Away,270,257,208,119,1,2,62,138,0,0,1,1
2017-09-24,3,PHI,NYG,Home,354,415,161,366,1,3,193,49,2,0,2,2
2017-10-01,4,TAM,NYG,Home,434,379,323,288,3,2,111,91,0,1,0,0
2017-10-08,5,NYG,LAC,Away,335,382,183,258,2,3,152,124,1,0,2,2
2017-10-15,6,DEN,NYG,Away,412,266,366,118,1,1,46,148,0,0,0,0
2017-10-22,7,NYG,SEA,Away,177,425,131,321,1,3,46,104,0,0,1,1
2017-11-05,9,NYG,LAR,Away,319,473,208,311,2,4,111,162,0,2,3,3
2017-11-12,10,SFO,NYG,Home,474,374,288,260,2,2,186,114,2,0,1,1
2017-11-19,11,NYG,KAN,Home,317,363,205,229,0,0,112,134,1,0,1,1
2017-11-23,12,WAS,NYG,Home,323,170,201,86,2,0,122,84,0,0,1,1
2017-12-03,13,LVR,NYG,Home,401,265,282,200,1,1,119,65,2,1,2,2
2017-12-10,14,NYG,DAL,Away,330,454,228,332,1,3,102,122,0,1,2,2
2017-12-17,15,NYG,PHI,Away,504,341,429,233,3,4,75,108,1,0,1,1
2017-12-24,16,ARI,NYG,Home,289,293,215,250,2,0,74,43,0,0,3,3
2017-12-31,17,NYG,WAS,Home,381,197,121,136,1,0,260,61,1,1,1,1
2018-09-09,1,NYG,JAX,Away,324,305,210,168,0,1,114,137,1,0,2,2
2018-09-16,2,DAL,NYG,Home,298,255,160,220,1,1,138,35,1,0,1,1
2018-09-23,3,HOU,NYG,Away,427,379,368,265,2,2,59,114,0,1,0,0
2018-09-30,4,NYG,NOR,Away,299,389,234,219,1,0,65,170,1,3,2,2
2018-10-07,5,CAR,NYG,Home,350,432,232,382,2,3,118,50,0,0,3,3
2018-10-11,6,NYG,PHI,Away,401,379,254,271,0,3,147,108,1,1,1,1
2018-10-22,7,ATL,NYG,Home,423,433,356,372,1,1,67,61,1,1,0,0
2018-10-28,8,NYG,WAS,Away,303,360,266,178,1,1,37,182,0,1,2,2
2018-11-12,10,SFO,NYG,Away,374,277,250,180,1,3,124,97,1,0,0,0
2018-11-18,11,NYG,TAM,Home,359,510,196,359,2,2,163,151,2,2,0,0
2018-11-25,12,PHI,NYG,Home,341,402,214,276,1,1,127,126,1,1,1,1
2018-12-02,13,NYG,CHI,Home,338,376,197,258,2,2,141,118,0,1,1,1
2018-12-09,14,WAS,NYG,Away,288,402,204,175,1,3,84,227,1,1,1,1
2018-12-16,15,NYG,TEN,Away,260,301,213,86,0,0,47,215,0,2,2,2
2018-12-23,16,IND,NYG,Home,402,392,353,309,2,1,49,83,2,2,1,1
2018-12-30,17,NYG,DAL,Away,441,419,298,368,2,4,143,51,2,1,2,2
2019-09-08,1,DAL,NYG,Home,494,470,405,319,4,1,89,151,1,1,2,2
2019-09-15,2,NYG,BUF,Away,370,388,241,237,1,1,129,151,1,3,2,2
2019-09-22,3,TAM,NYG,Away,499,384,355,312,3,2,144,72,0,2,2,2
2019-09-29,4,NYG,WAS,Home,389,176,225,121,1,0,164,55,1,0,4,4
2019-10-06,5,NYG,MIN,Away,211,490,147,279,1,2,64,211,0,0,1,1
2019-10-10,6,NWE,NYG,Home,427,213,313,161,0,1,114,52,3,0,4,4
2019-10-20,7,NYG,ARI,Away,263,245,156,89,1,0,107,156,1,3,3,3
2019-10-27,8,DET,NYG,Home,375,370,316,290,3,4,59,80,0,0,1,1
2019-11-04,9,NYG,DAL,Away,271,429,171,257,1,3,100,172,0,0,3,3
2019-11-10,10,NYJ,NYG,Home,294,281,218,258,1,4,76,23,2,0,2,2
2019-11-24,12,CHI,NYG,Home,335,243,270,134,1,2,65,109,1,0,1,1
2019-12-01,13,NYG,GNB,Away,335,322,240,243,1,4,95,79,0,0,3,3
2019-12-09,14,PHI,NYG,Home,418,255,300,182,2,2,118,73,1,0,0,0
2019-12-15,15,NYG,MIA,Home,412,384,274,262,2,2,138,122,3,0,3,3
2019-12-22,16,WAS,NYG,Away,361,552,281,346,3,5,80,206,2,1,0,0
2019-12-29,17,NYG,PHI,Away,397,400,275,279,1,1,122,121,1,3,2,2
2020-09-14,1,NYG,PIT,Away,291,349,262,208,2,3,29,141,0,0,2,2
2020-09-20,2,CHI,NYG,Home,304,295,169,220,2,0,135,75,0,1,2,2
2020-09-27,3,NYG,SFO,Away,231,420,165,327,0,1,66,93,0,3,3,3
2020-10-04,4,LAR,NYG,Home,240,295,182,159,1,0,58,136,1,0,1,1
2020-10-11,5,DAL,NYG,Home,402,300,276,211,1,0,126,89,2,2,1,1
2020-10-18,6,NYG,WAS,Home,240,337,108,251,1,2,132,86,0,0,1,1
2020-10-22,7,PHI,NYG,Home,442,325,346,165,2,2,96,160,1,1,3,3
2020-11-02,8,NYG,TAM,Away,357,344,256,263,2,2,101,81,1,0,2,2
2020-11-08,9,WAS,NYG,Away,402,350,365,184,1,1,37,166,1,1,0,0
2020-11-15,10,NYG,PHI,Home,382,346,231,190,0,0,151,156,3,2,0,0
2020-11-29,12,CIN,NYG,Away,155,386,115,244,1,0,40,142,0,1,1,1
2020-12-06,13,SEA,NYG,Away,327,290,216,100,1,1,111,190,0,1,1,1
2020-12-13,14,NYG,ARI,Away,159,390,81,231,0,1,78,159,1,1,3,3
2020-12-20,15,NYG,CLE,Away,288,392,214,286,0,2,74,106,0,1,0,0
2020-12-27,16,BAL,NYG,Home,432,269,183,215,2,1,249,54,1,0,0,0
2021-01-03,17,NYG,DAL,Home,336,307,211,199,2,0,125,108,1,1,2,2
2021-09-12,1,NYG,DEN,Away,314,420,254,255,1,2,60,165,1,1,1,1
2021-09-16,2,WAS,NYG,Home,407,391,320,228,2,1,87,163,1,1,0,0
2021-09-26,3,NYG,ATL,Away,346,296,246,227,0,2,100,69,1,0,1,1
2021-10-03,4,NOR,NYG,Away,405,485,235,402,1,2,170,83,2,1,1,1
2021-10-10,5,DAL,NYG,Home,515,367,314,294,3,1,201,73,1,1,2,2
2021-10-17,6,NYG,LAR,Away,261,365,201,234,0,4,60,131,1,1,4,4
2021-10-24,7,NYG,CAR,Home,302,173,199,117,1,0,103,56,1,0,0,0
2021-11-01,8,KAN,NYG,Home,368,300,261,228,1,2,107,72,1,0,1,1
2021-11-07,9,NYG,LVR,Home,247,403,98,286,1,1,149,117,0,0,1,1
2021-11-22,11,TAM,NYG,Home,402,215,308,149,2,1,94,66,1,0,3,3
2021-11-28,12,NYG,PHI,Home,264,332,194,124,1,0,70,208,0,1,0,0
2021-12-05,13,MIA,NYG,Home,297,250,229,159,2,0,68,91,0,0,1,1
2021-12-12,14,LAC,NYG,Home,423,316,271,181,3,2,152,135,1,1,2,2
2021-12-19,15,NYG,DAL,Away,302,328,178,203,0,1,124,125,0,1,4,4
2021-12-26,16,PHI,NYG,Home,324,192,194,108,2,1,130,84,1,0,2,2
2022-01-09,18,NYG,WAS,Away,177,325,83,99,1,0,94,226,0,1,3,3
2022-09-11,1,TEN,NYG,Away,359,394,266,156,2,2,93,238,0,1,2,2
2022-09-18,2,NYG,CAR,Home,265,275,162,129,1,1,103,146,0,0,0,0
2022-09-26,3,NYG,DAL,Away,336,391,169,215,0,1,167,176,1,1,1,1
2022-10-02,4,NYG,CHI,Home,333,304,71,155,0,0,262,149,2,0,2,2
2022-10-09,5,GNB,NYG,Away,301,338,207,213,2,0,94,125,0,3,0,0
2022-10-16,6,NYG,BAL,Home,238,406,155,195,2,1,83,211,1,1,1,1
2022-10-23,7,JAX,NYG,Away,452,436,310,200,0,1,142,236,2,1,0,0
2022-10-30,8,SEA,NYG,Home,277,225,190,147,2,0,87,78,1,1,2,2
2022-11-13,10,NYG,HOU,Home,367,387,176,286,2,1,191,101,1,0,0,0
2022-11-20,11,NYG,DET,Away,413,325,324,165,1,0,89,160,2,4,3,3
2022-11-24,12,DAL,NYG,Home,430,300,261,210,2,1,169,90,2,1,0,0
2022-12-04,13,NYG,WAS,Away,316,411,182,246,1,2,134,165,1,0,1,1
2022-12-11,14,NYG,PHI,Away,304,437,181,184,2,2,123,253,1,4,1,1
2022-12-18,15,WAS,NYG,Away,387,288,228,160,1,0,159,128,0,1,0,0
2022-12-24,16,MIN,NYG,Home,353,445,270,319,3,1,83,126,0,1,2,2
2023-01-01,17,NYG,IND,Home,394,252,177,124,2,1,217,128,2,0,1,1
2023-01-08,18,PHI,NYG,Home,342,284,207,155,0,1,135,129,1,1,0,0
2023-09-10,1,NYG,DAL,Away,171,265,63,143,0,0,108,122,0,3,3,3
2023-09-17,2,ARI,NYG,Away,379,439,228,312,1,2,151,127,2,2,1,1
2023-09-21,3,SFO,NYG,Home,441,150,300,121,2,0,141,29,1,1,1,1
2023-10-02,4,NYG,SEA,Away,248,281,136,160,0,1,112,121,0,1,3,3
2023-10-08,5,MIA,NYG,Home,524,268,302,183,2,0,222,85,2,0,0,0
2023-10-15,6,BUF,NYG,Home,297,317,169,185,2,0,128,132,0,0,0,0
2023-10-22,7,NYG,WAS,Home,356,273,250,197,2,0,106,76,0,1,2,2
2023-11-05,9,LVR,NYG,Home,334,277,209,154,0,1,125,123,3,0,2,2
2023-11-12,10,DAL,NYG,Home,640,172,472,61,4,2,168,111,3,0,1,1
2023-11-19,11,WAS,NYG,Away,404,292,230,201,1,3,174,91,1,0,0,0
2023-11-26,12,NYG,NWE,Home,220,283,162,136,1,0,58,147,0,1,1,1
2023-12-11,14,NYG,GNB,Home,367,326,158,203,1,1,209,123,2,1,2,2
2023-12-17,15,NOR,NYG,Home,296,193,209,133,3,0,87,60,0,0,0,0
2023-12-25,16,PHI,NYG,Home,465,292,295,186,1,1,170,106,2,1,1,1
2023-12-31,17,NYG,LAR,Away,389,391,284,286,1,1,105,105,1,3,1,1
2024-01-07,18,NYG,PHI,Home,415,299,306,166,1,1,109,133,2,0,1,1
2014-09-07,1,NYJ,LVR,Home,402,158,190,133,1,2,212,25,1,0,2,2
2014-09-14,2,GNB,NYJ,Home,390,313,310,166,3,1,80,147,0,2,1,1
2014-09-22,3,NYJ,CHI,Away,414,257,300,197,1,2,114,60,0,0,3,3
2014-09-28,4,NYJ,DET,Away,336,360,204,272,1,2,132,88,1,1,2,2
2014-10-05,5,LAC,NYJ,Home,439,151,277,60,3,0,162,91,1,0,2,2
2014-10-12,6,NYJ,DEN,Away,204,359,173,221,2,3,31,138,0,0,2,2
2014-10-16,7,NWE,NYJ,Home,323,423,260,205,3,1,63,218,0,1,0,0
2014-10-26,8,NYJ,BUF,Away,312,280,137,213,0,4,175,67,3,1,6,6
2014-11-02,9,KAN,NYJ,Home,309,364,196,225,2,1,113,139,1,0,0,0
2014-11-09,10,NYJ,PIT,Home,275,362,125,326,2,1,150,36,0,0,0,0
2014-11-24,12,BUF,NYJ,Home,336,218,220,126,2,0,116,92,2,0,1,1
2014-12-01,13,NYJ,MIA,Away,326,291,49,217,0,0,277,74,1,1,1,1
2014-12-07,14,MIN,NYJ,Home,411,410,297,242,2,1,114,168,0,0,2,2
2014-12-14,15,TEN,NYJ,Away,342,277,253,163,0,1,89,114,0,1,0,0
2014-12-21,16,NYJ,NWE,Away,307,231,191,146,1,1,116,85,0,1,1,1
2014-12-28,17,MIA,NYJ,Away,387,494,208,390,1,3,179,104,2,1,1,1
2015-09-13,1,NYJ,CLE,Home,333,321,179,217,2,1,154,104,2,0,1,1
2015-09-21,2,IND,NYJ,Away,343,344,250,243,1,2,93,101,0,0,1,1
2015-09-27,3,NYJ,PHI,Away,323,231,276,108,2,1,47,123,0,1,4,4
2015-10-04,4,MIA,NYJ,Away,226,425,167,218,2,1,59,207,0,2,1,1
2015-10-18,6,NYJ,WAS,Home,474,225,253,191,2,1,221,34,2,0,3,3
2015-10-25,7,NWE,NYJ,Home,353,372,337,283,2,2,16,89,1,0,1,1
2015-11-01,8,LVR,NYJ,Home,451,366,333,292,4,2,118,74,0,0,1,1
2015-11-08,9,NYJ,JAX,Home,290,436,261,338,2,2,29,98,2,0,0,0
2015-11-12,10,NYJ,BUF,Away,318,280,190,132,2,1,128,148,0,0,4,4
2015-11-22,11,HOU,NYJ,Home,364,267,241,197,3,1,123,70,0,1,2,2
2015-11-29,12,NYJ,MIA,Home,411,333,274,321,4,3,137,12,1,0,0,0
2015-12-06,13,NYG,NYJ,Away,355,463,281,373,1,2,74,90,0,0,1,1
2015-12-13,14,NYJ,TEN,Home,439,292,256,268,3,1,183,24,0,0,0,0
2015-12-19,15,DAL,NYJ,Away,309,372,176,299,1,1,133,73,0,1,1,1
2015-12-27,16,NYJ,NWE,Home,428,284,285,221,3,1,143,63,0,0,1,1
2016-01-03,17,BUF,NYJ,Home,295,300,182,178,0,2,113,122,2,0,3,3
2016-09-11,1,NYJ,CIN,Away,340,381,188,324,2,1,152,57,0,1,1,1
2016-09-15,2,BUF,NYJ,Away,393,493,307,370,3,1,86,123,0,3,1,1
2016-09-25,3,KAN,NYJ,Home,293,305,221,188,1,0,72,117,0,0,8,8
2016-10-02,4,NYJ,SEA,Away,305,354,247,288,1,3,58,66,0,0,3,3
2016-10-09,5,PIT,NYJ,Home,436,316,375,244,4,1,61,72,0,0,0,0
2016-10-17,6,ARI,NYJ,Home,396,230,225,197,1,0,171,33,3,0,2,2
2016-10-23,7,NYJ,BAL,Home,344,245,189,234,2,0,155,11,1,0,2,2
2016-10-30,8,CLE,NYJ,Away,407,393,339,222,2,1,68,171,1,3,0,0
2016-11-06,9,MIA,NYJ,Home,274,331,137,191,1,1,137,140,1,1,2,2
2016-11-13,10,NYJ,LAR,Away,296,280,157,155,1,0,139,125,0,0,1,1
2016-11-27,12,NYJ,NWE,Away,333,377,269,286,2,2,64,91,0,0,2,2
2016-12-05,13,NYJ,IND,Away,250,421,214,282,1,4,36,139,0,1,3,3
2016-12-11,14,SFO,NYJ,Away,364,404,116,216,1,0,248,188,1,2,1,1
2016-12-17,15,NYJ,MIA,Away,360,303,244,236,1,4,116,67,0,0,4,4
2016-12-24,16,NWE,NYJ,Home,325,239,211,128,3,0,114,111,2,0,4,4
2017-01-01,17,NYJ,BUF,Home,329,230,202,162,2,0,127,68,0,1,0,0
2017-09-10,1,BUF,NYJ,Home,408,214,218,176,2,0,190,38,1,1,2,2
2017-09-17,2,LVR,NYJ,Home,410,271,230,145,3,2,180,126,3,0,2,2
2017-09-24,3,NYJ,MIA,Home,336,225,233,195,1,1,103,30,1,0,1,1
2017-10-01,4,NYJ,JAX,Home,471,311,215,136,0,1,256,175,2,0,2,2
2017-10-08,5,CLE,NYJ,Away,419,212,279,178,2,2,140,34,0,0,1,1
2017-10-15,6,NYJ,NWE,Away,408,375,334,257,2,2,74,118,0,1,3,3
2017-10-22,7,MIA,NYJ,Home,357,272,304,180,4,3,53,92,0,1,2,2
2017-10-29,8,NYJ,ATL,Away,279,386,236,246,2,2,43,140,0,0,1,1
2017-11-02,9,NYJ,BUF,Home,331,307,137,244,1,2,194,63,3,1,0,0
2017-11-12,10,TAM,NYJ,Home,271,275,181,219,1,1,90,56,0,0,2,2
2017-11-26,12,NYJ,CAR,Away,391,299,282,154,3,0,109,145,0,2,1,1
2017-12-03,13,NYJ,KAN,Home,488,474,331,362,1,4,157,112,3,0,0,0
2017-12-10,14,DEN,NYJ,Home,273,100,189,41,1,0,84,59,1,0,2,2
2017-12-17,15,NOR,NYJ,Home,412,294,281,170,2,1,131,124,2,1,2,2
2017-12-24,16,NYJ,LAC,Away,295,379,98,290,0,1,197,89,1,1,3,3
2017-12-31,17,NWE,NYJ,Home,330,247,183,207,2,0,147,40,1,0,0,0
2018-09-10,1,DET,NYJ,Away,339,349,300,180,1,2,39,169,0,2,2,2
2018-09-16,2,NYJ,MIA,Away,362,257,320,122,1,2,42,135,0,1,3,3
2018-09-20,3,CLE,NYJ,Home,323,268,190,161,0,0,133,107,2,2,3,3
2018-09-30,4,JAX,NYJ,Home,503,178,377,144,2,1,126,34,1,0,0,0
2018-10-07,5,NYJ,DEN,Home,512,436,189,344,3,2,323,92,1,0,2,2
2018-10-14,6,NYJ,IND,Home,374,428,267,301,2,4,107,127,0,0,2,2
2018-10-21,7,NYJ,MIN,Away,263,316,192,228,1,2,71,88,1,2,4,4
2018-10-28,8,CHI,NYJ,Home,395,207,216,150,2,1,179,57,1,0,0,0
2018-11-04,9,MIA,NYJ,Home,168,282,104,202,0,0,64,80,0,0,4,4
2018-11-11,10,NYJ,BUF,Away,199,451,116,239,0,2,83,212,1,2,2,2
2018-11-25,12,NYJ,NWE,Away,338,498,264,283,1,2,74,215,0,1,1,1
2018-12-02,13,TEN,NYJ,Home,403,280,273,124,2,0,130,156,1,0,1,1
2018-12-09,14,BUF,NYJ,Away,368,248,192,170,0,1,176,78,2,2,2,2
2018-12-15,15,NYJ,HOU,Away,318,286,228,239,2,2,90,47,1,0,1,1
2018-12-23,16,NYJ,GNB,Away,370,540,323,413,3,2,47,127,1,3,0,0
2018-12-30,17,NWE,NYJ,Home,375,239,244,135,4,0,131,104,0,0,3,3
2019-09-08,1,NYJ,BUF,Away,223,370,155,242,1,1,68,128,0,1,1,1
2019-09-16,2,NYJ,CLE,Away,262,375,169,305,0,1,93,70,0,1,1,1
2019-09-22,3,NWE,NYJ,Home,381,105,313,69,2,0,68,36,2,0,1,1
2019-10-06,5,PHI,NYJ,Home,265,128,181,61,1,0,84,67,1,1,3,3
2019-10-13,6,NYJ,DAL,Home,382,399,326,270,2,0,56,129,1,2,1,1
2019-10-21,7,NYJ,NWE,Away,154,323,73,249,0,1,81,74,0,3,6,6
2019-10-27,8,JAX,NYJ,Home,389,213,278,167,3,2,111,46,0,0,3,3
2019-11-03,9,MIA,NYJ,Home,316,321,266,238,3,1,50,83,0,0,1,1
2019-11-10,10,NYJ,NYG,Home,294,281,218,258,1,4,76,23,2,0,0,0
2019-11-17,11,WAS,NYJ,Away,225,400,171,285,2,4,54,115,0,1,2,2
2019-11-24,12,NYJ,LVR,Home,401,208,313,140,2,0,88,68,1,0,1,1
2019-12-01,13,CIN,NYJ,Home,277,271,233,209,1,0,44,62,1,0,0,0
2019-12-08,14,NYJ,MIA,Home,374,362,262,240,2,0,112,122,0,0,1,1
2019-12-12,15,BAL,NYJ,Home,430,310,212,207,5,2,218,103,1,0,2,2
2019-12-22,16,NYJ,PIT,Home,259,260,174,185,1,1,85,75,0,0,1,1
2019-12-29,17,BUF,NYJ,Away,309,271,236,185,0,1,73,86,0,0,1,1
2020-09-13,1,BUF,NYJ,Home,404,254,306,202,2,1,98,52,1,1,2,2
2020-09-20,2,NYJ,SFO,Away,277,359,173,177,1,2,104,182,0,2,0,0
2020-09-27,3,IND,NYJ,Home,353,260,234,151,1,1,119,109,1,0,3,3
2020-10-01,4,NYJ,DEN,Away,321,359,192,242,0,2,129,117,1,2,0,0
2020-10-11,5,NYJ,ARI,Away,285,496,162,369,1,1,123,127,0,3,0,0
2020-10-18,6,MIA,NYJ,Home,302,263,192,148,3,0,110,115,0,0,1,1
2020-10-25,7,NYJ,BUF,Away,191,422,91,296,0,0,100,126,1,0,2,2
2020-11-01,8,KAN,NYJ,Home,496,221,446,128,5,0,50,93,0,0,1,1
2020-11-09,9,NYJ,NWE,Away,322,433,257,274,3,0,65,159,0,3,1,1
2020-11-22,11,LAC,NYJ,Home,376,292,347,196,3,2,29,96,0,2,1,1
2020-11-29,12,NYJ,MIA,Away,260,345,173,241,0,2,87,104,0,0,2,2
2020-12-06,13,NYJ,LVR,Away,376,440,170,368,2,3,206,72,2,1,3,3
2020-12-13,14,SEA,NYJ,Home,410,185,236,116,4,0,174,69,1,0,1,1
2020-12-20,15,LAR,NYJ,Away,303,289,189,196,2,1,114,93,0,1,0,0
2020-12-27,16,NYJ,CLE,Home,333,299,202,254,3,0,131,45,0,2,0,0
2021-01-03,17,NWE,NYJ,Home,404,350,238,239,4,1,166,111,0,1,2,2
2021-09-12,1,CAR,NYJ,Home,381,252,270,207,1,2,111,45,1,0,1,1
2021-09-19,2,NYJ,NWE,Away,336,260,184,159,0,0,152,101,0,2,4,4
2021-09-26,3,DEN,NYJ,Home,343,162,223,119,0,0,120,43,2,0,2,2
2021-10-03,4,NYJ,TEN,Home,355,430,289,253,2,1,66,177,1,1,1,1
2021-10-10,5,ATL,NYJ,Home,450,230,342,166,2,0,108,64,1,2,1,1
2021-10-24,7,NWE,NYJ,Home,551,299,403,237,3,1,148,62,4,1,3,3
2021-10-31,8,NYJ,CIN,Home,511,318,414,277,3,3,97,41,1,1,3,3
2021-11-04,9,IND,NYJ,Home,532,486,272,398,3,4,260,88,3,0,2,2
2021-11-14,10,NYJ,BUF,Away,366,489,296,350,1,2,70,139,1,4,5,5
2021-11-21,11,NYJ,MIA,Away,380,388,278,273,2,2,102,115,0,1,1,1
2021-11-28,12,HOU,NYJ,Away,202,266,106,109,2,0,96,157,0,2,1,1
2021-12-05,13,NYJ,PHI,Away,281,418,211,233,2,2,70,185,1,1,1,1
2021-12-12,14,NYJ,NOR,Away,256,344,178,141,0,0,78,203,0,3,0,0
2021-12-19,15,MIA,NYJ,Home,379,228,196,126,2,0,183,102,2,2,1,1
2021-12-26,16,NYJ,JAX,Home,373,384,100,252,1,0,273,132,1,1,0,0
2022-01-02,17,NYJ,TAM,Away,374,467,224,405,1,3,150,62,2,0,1,1
2022-01-09,18,BUF,NYJ,Home,424,53,254,5,2,1,170,48,1,0,0,0
2022-09-11,1,NYJ,BAL,Away,380,274,297,211,1,3,83,63,0,0,2,2
2022-09-18,2,CLE,NYJ,Away,405,402,221,309,1,4,184,93,3,0,1,1
2022-09-25,3,NYJ,CIN,Away,328,330,252,261,0,3,76,69,0,0,4,4
2022-10-02,4,PIT,NYJ,Away,297,348,178,250,0,2,119,98,2,1,2,2
2022-10-09,5,NYJ,MIA,Home,322,295,187,158,0,0,135,137,5,2,0,0
2022-10-16,6,GNB,NYJ,Away,278,278,218,99,1,0,60,179,0,2,0,0
2022-10-23,7,DEN,NYJ,Away,324,260,219,105,0,0,105,155,1,1,0,0
2022-10-30,8,NYJ,NWE,Away,387,288,336,161,2,1,51,127,0,0,3,3
2022-11-06,9,NYJ,BUF,Home,310,317,136,183,1,0,174,134,1,2,1,1
2022-11-20,11,NWE,NYJ,Home,297,103,198,44,0,0,99,59,0,0,0,0
2022-11-27,12,NYJ,CHI,Home,466,292,308,165,3,1,158,127,1,0,0,0
2022-12-04,13,MIN,NYJ,Home,287,486,159,366,1,0,128,120,2,1,2,2
2022-12-11,14,BUF,NYJ,Home,232,309,130,233,1,0,102,76,1,1,2,2
2022-12-18,15,NYJ,DET,Away,337,359,287,252,2,1,50,107,0,0,1,1
2022-12-22,16,NYJ,JAX,Away,227,365,161,218,0,0,66,147,0,1,2,2
2023-01-01,17,SEA,NYJ,Home,346,279,148,204,2,0,198,75,0,0,3,3
2023-01-08,18,MIA,NYJ,Home,302,187,140,149,0,0,162,38,0,0,0,0
2023-09-11,1,NYJ,BUF,Home,289,314,117,217,1,1,172,97,0,0,1,1
2023-09-17,2,DAL,NYJ,Home,382,215,248,151,2,1,134,64,0,0,4,4
2023-09-24,3,NYJ,NWE,Away,171,358,133,201,0,1,38,157,1,0,0,0
2023-10-01,4,NYJ,KAN,Away,336,401,228,197,2,1,108,204,0,1,1,1
2023-10-08,5,DEN,NYJ,Away,308,407,169,173,2,0,139,234,0,1,2,2
2023-10-15,6,NYJ,PHI,Home,244,348,155,268,0,1,89,80,1,1,0,0
2023-11-06,9,NYJ,LAC,Away,270,191,206,107,0,0,64,84,0,2,3,3
2023-11-12,10,LVR,NYJ,Home,274,365,126,257,1,0,148,108,0,0,1,1
2023-11-19,11,BUF,NYJ,Home,393,155,263,92,3,1,130,63,0,0,4,4
2023-11-24,12,NYJ,MIA,Away,159,395,130,228,1,1,29,167,0,2,2,2
2023-12-03,13,NYJ,ATL,Away,259,194,197,104,0,1,62,90,0,0,3,3
2023-12-10,14,NYJ,HOU,Home,347,135,268,54,2,0,79,81,1,1,1,1
2023-12-17,15,MIA,NYJ,Home,290,103,213,80,1,0,77,23,2,0,4,4
2023-12-24,16,NYJ,WAS,Home,381,245,217,143,1,1,164,102,2,3,2,2
2023-12-28,17,CLE,NYJ,Home,428,360,301,253,3,1,127,107,1,0,2,2
2024-01-07,18,NWE,NYJ,Away,119,254,31,69,0,0,88,185,0,1,1,1
2014-09-07,1,PHI,JAX,Home,420,306,275,242,2,2,145,64,1,0,3,3
2014-09-15,2,IND,PHI,Away,341,458,172,331,3,1,169,127,0,2,1,1
2014-09-21,3,PHI,WAS,Home,379,511,325,427,3,3,54,84,0,1,1,1
2014-09-28,4,SFO,PHI,Home,407,213,189,191,2,0,218,22,0,0,4,4
2014-10-05,5,PHI,LAR,Home,352,466,207,341,2,3,145,125,0,1,3,3
2014-10-12,6,PHI,NYG,Home,448,254,245,168,2,0,203,86,1,0,2,2
2014-10-26,8,ARI,PHI,Home,400,521,329,411,2,2,71,110,1,0,3,3
2014-11-02,9,HOU,PHI,Away,300,483,182,293,2,3,118,190,0,1,4,4
2014-11-10,10,PHI,CAR,Home,365,317,328,215,2,2,37,102,2,1,0,0
2014-11-16,11,GNB,PHI,Home,475,429,365,320,3,2,110,109,1,0,4,4
2014-11-23,12,PHI,TEN,Home,462,351,298,299,1,2,164,52,2,1,2,2
2014-11-27,13,DAL,PHI,Away,267,464,174,208,0,1,93,256,1,2,1,1
2014-12-07,14,PHI,SEA,Away,139,440,82,252,2,2,57,188,0,1,2,2
2014-12-14,15,PHI,DAL,Away,294,364,219,249,0,3,75,115,3,2,3,3
2014-12-20,16,WAS,PHI,Home,305,495,205,361,0,2,100,134,3,1,2,2
2014-12-28,17,NYG,PHI,Away,505,426,429,262,1,2,76,164,1,1,1,1
2015-09-14,1,ATL,PHI,Home,395,399,290,336,2,1,105,63,0,2,2,2
2015-09-20,2,PHI,DAL,Away,226,359,219,250,1,1,7,109,0,0,3,3
2015-09-27,3,NYJ,PHI,Away,323,231,276,108,2,1,47,123,0,1,1,1
2015-10-04,4,WAS,PHI,Home,417,320,290,233,1,3,127,87,1,0,2,2
2015-10-11,5,PHI,NOR,Home,519,388,333,292,2,2,186,96,2,0,2,2
2015-10-19,6,PHI,NYG,Home,428,247,270,166,1,1,158,81,1,0,4,4
2015-10-25,7,CAR,PHI,Home,394,349,190,172,1,0,204,177,2,1,1,1
2015-11-08,9,DAL,PHI,Away,411,459,277,287,3,1,134,172,0,2,0,0
2015-11-15,10,PHI,MIA,Away,436,289,353,190,1,2,83,99,1,0,1,1
2015-11-22,11,PHI,TAM,Away,383,521,247,238,2,5,136,283,0,0,4,4
2015-11-26,12,DET,PHI,Home,430,227,322,159,5,2,108,68,1,0,1,1
2015-12-06,13,NWE,PHI,Away,427,248,324,120,3,2,103,128,1,0,1,1
2015-12-13,14,PHI,BUF,Home,348,412,232,260,1,1,116,152,1,1,1,1
2015-12-20,15,PHI,ARI,Away,424,493,350,263,2,1,74,230,0,3,4,4
2015-12-26,16,PHI,WAS,Away,398,418,353,351,1,4,45,67,2,0,2,2
2016-01-03,17,NYG,PHI,Away,502,435,294,315,2,2,208,120,1,2,2,2
2016-09-11,1,PHI,CLE,Home,403,288,270,168,2,0,133,120,1,1,0,0
2016-09-19,2,CHI,PHI,Away,284,280,220,180,0,1,64,100,1,2,0,0
2016-09-25,3,PHI,PIT,Home,426,251,301,222,2,0,125,29,2,0,0,0
2016-10-09,5,DET,PHI,Home,244,346,164,230,3,2,80,116,0,0,2,2
2016-10-16,6,WAS,PHI,Home,493,239,263,145,2,0,230,94,1,0,0,0
2016-10-23,7,PHI,MIN,Home,239,282,138,189,1,1,101,93,0,0,4,4
2016-10-30,8,DAL,PHI,Home,460,291,273,194,2,1,187,97,1,1,1,1
2016-11-06,9,NYG,PHI,Home,302,443,248,347,4,0,54,96,0,2,2,2
2016-11-13,10,PHI,ATL,Home,429,303,221,255,0,1,208,48,2,0,1,1
2016-11-20,11,SEA,PHI,Home,439,308,287,195,2,2,152,113,1,0,2,2
2016-11-28,12,PHI,GNB,Away,292,387,211,313,0,2,81,74,1,1,1,1
2016-12-04,13,CIN,PHI,Home,412,359,332,306,2,1,80,53,1,1,3,3
2016-12-11,14,PHI,WAS,Away,383,334,288,227,1,2,95,107,0,2,2,2
2016-12-18,15,BAL,PHI,Home,340,328,189,159,2,0,151,169,1,2,1,1
2016-12-22,16,PHI,NYG,Home,286,470,168,356,1,1,118,114,1,0,1,1
2017-01-01,17,PHI,DAL,Home,346,195,232,126,2,1,114,69,1,0,0,0
2017-09-10,1,WAS,PHI,Away,264,356,200,298,1,2,64,58,0,0,2,2
2017-09-17,2,KAN,PHI,Home,344,406,232,299,1,2,112,107,2,0,2,2
2017-09-24,3,PHI,NYG,Home,354,415,161,366,1,3,193,49,2,0,1,1
2017-10-01,4,LAC,PHI,Away,400,454,342,240,2,1,58,214,1,1,0,0
2017-10-08,5,PHI,ARI,Home,419,307,297,276,4,1,122,31,0,0,1,1
2017-10-12,6,CAR,PHI,Away,305,310,225,209,1,3,80,101,1,0,1,1
2017-10-23,7,PHI,WAS,Home,371,344,244,269,4,3,127,75,0,0,1,1
2017-10-29,8,PHI,SFO,Home,304,238,192,144,2,1,112,94,1,0,1,1
2017-11-05,9,PHI,DEN,Home,419,226,222,191,4,1,197,35,3,0,1,1
2017-11-19,11,DAL,PHI,Away,225,383,113,168,0,2,112,215,0,2,0,0
2017-11-26,12,PHI,CHI,Home,420,140,244,134,3,0,176,6,0,0,3,3
2017-12-03,13,SEA,PHI,Home,310,425,209,327,3,1,101,98,0,0,2,2
2017-12-10,14,LAR,PHI,Away,307,455,198,316,2,4,109,139,2,0,1,1
2017-12-17,15,NYG,PHI,Away,504,341,429,233,3,4,75,108,1,0,0,0
2017-12-25,16,PHI,LVR,Home,216,274,138,137,1,1,78,137,0,0,2,2
2017-12-31,17,PHI,DAL,Away,219,301,149,172,0,1,70,129,0,0,2,2
2018-09-06,1,PHI,ATL,Home,232,299,119,225,0,0,113,74,2,1,2,2
2018-09-16,2,TAM,PHI,Home,436,412,393,321,4,1,43,91,0,2,2,2
2018-09-23,3,PHI,IND,Home,379,209,227,141,1,1,152,68,1,0,2,2
2018-09-30,4,TEN,PHI,Home,397,432,327,315,2,2,70,117,1,0,1,1
2018-10-07,5,PHI,MIN,Away,364,375,283,298,2,1,81,77,0,0,2,2
2018-10-11,6,NYG,PHI,Away,401,379,254,271,0,3,147,108,1,1,0,0
2018-10-21,7,PHI,CAR,Away,342,371,284,250,2,2,58,121,0,1,1,1
2018-10-28,8,JAX,PHI,Away,335,395,265,262,1,3,70,133,0,0,2,2
2018-11-11,10,PHI,DAL,Away,421,410,350,239,2,1,71,171,0,2,1,1
2018-11-18,11,NOR,PHI,Home,546,196,373,138,4,0,173,58,2,1,3,3
2018-11-25,12,PHI,NYG,Home,341,402,214,276,1,1,127,126,1,1,0,0
2018-12-03,13,PHI,WAS,Home,436,235,306,131,2,0,130,104,1,1,1,1
2018-12-09,14,DAL,PHI,Home,576,256,434,222,3,3,142,34,0,0,1,1
2018-12-16,15,LAR,PHI,Away,407,381,325,270,0,0,82,111,2,3,1,1
2018-12-23,16,PHI,HOU,Home,519,371,462,309,4,2,57,62,0,2,3,3
2018-12-30,17,WAS,PHI,Away,89,360,68,231,0,3,21,129,0,0,1,1
2019-09-08,1,PHI,WAS,Home,436,398,313,370,3,3,123,28,1,0,0,0
2019-09-15,2,ATL,PHI,Home,367,286,310,237,3,1,57,49,0,1,3,3
2019-09-22,3,PHI,DET,Away,373,287,246,201,2,1,127,86,1,1,2,2
2019-09-26,4,GNB,PHI,Away,491,336,414,160,2,3,77,176,1,2,0,0
2019-10-06,5,PHI,NYJ,Home,265,128,181,61,1,0,84,67,1,1,1,1
2019-10-13,6,MIN,PHI,Home,447,400,325,292,4,2,122,108,1,0,3,3
2019-10-20,7,DAL,PHI,Home,402,283,213,168,1,1,189,115,3,0,4,4
2019-10-27,8,BUF,PHI,Away,253,371,155,153,2,1,98,218,0,3,1,1
2019-11-03,9,PHI,CHI,Home,373,164,227,102,1,0,146,62,1,2,0,0
2019-11-17,11,PHI,NWE,Away,255,298,174,224,1,1,81,74,0,0,1,1
2019-11-24,12,PHI,SEA,Away,344,348,238,174,1,1,106,174,0,1,5,5
2019-12-01,13,MIA,PHI,Home,409,386,351,294,4,3,58,92,1,0,1,1
2019-12-09,14,PHI,NYG,Home,418,255,300,182,2,2,118,73,1,0,1,1
2019-12-15,15,WAS,PHI,Away,352,415,251,258,2,3,101,157,1,1,1,1
2019-12-22,16,PHI,DAL,Home,431,311,313,257,1,0,118,54,1,0,0,0
2019-12-29,17,NYG,PHI,Away,397,400,275,279,1,1,122,121,1,3,0,0
2020-09-13,1,WAS,PHI,Home,239,265,159,208,1,2,80,57,2,0,3,3
2020-09-20,2,PHI,LAR,Away,363,449,242,258,0,3,121,191,2,2,3,3
2020-09-27,3,PHI,CIN,Away,378,304,206,256,1,2,172,48,1,0,2,2
2020-10-04,4,SFO,PHI,Away,417,267,301,174,1,1,116,93,2,1,1,1
2020-10-11,5,PIT,PHI,Home,367,336,231,242,3,2,136,94,2,2,2,2
2020-10-18,6,PHI,BAL,Away,364,355,170,173,2,1,194,182,1,2,1,1
2020-10-22,7,PHI,NYG,Home,442,325,346,165,2,2,96,160,1,1,1,1
2020-11-01,8,PHI,DAL,Home,222,265,103,132,2,0,119,133,0,0,4,4
2020-11-15,10,NYG,PHI,Home,382,346,231,190,0,0,151,156,3,2,0,0
2020-11-22,11,CLE,PHI,Home,324,315,187,209,0,2,137,106,1,0,3,3
2020-11-30,12,PHI,SEA,Away,250,301,180,225,2,1,70,76,0,1,1,1
2020-12-06,13,GNB,PHI,Home,437,278,288,161,3,1,149,117,1,0,1,1
2020-12-13,14,PHI,NOR,Home,413,358,167,262,1,2,246,96,2,1,1,1
2020-12-20,15,ARI,PHI,Home,526,422,423,305,3,3,103,117,1,1,0,0
2020-12-27,16,DAL,PHI,Home,513,477,362,326,3,1,151,151,1,1,3,3
2021-01-03,17,PHI,WAS,Away,216,248,98,145,0,2,118,103,2,0,3,3
2021-09-12,1,ATL,PHI,Away,260,434,136,261,0,3,124,173,0,1,0,0
2021-09-19,2,PHI,SFO,Away,328,306,177,189,0,1,151,117,1,1,0,0
2021-09-27,3,DAL,PHI,Home,380,367,220,303,3,2,160,64,2,0,2,2
2021-10-03,4,PHI,KAN,Away,461,471,358,271,2,5,103,200,1,1,0,0
2021-10-10,5,CAR,PHI,Away,267,273,158,182,1,0,109,91,0,2,2,2
2021-10-14,6,PHI,TAM,Away,213,399,113,297,1,2,100,102,2,2,1,1
2021-10-24,7,LVR,PHI,Home,442,358,323,223,2,2,119,135,2,1,2,2
2021-10-31,8,DET,PHI,Away,228,350,171,114,0,0,57,236,1,4,0,0
2021-11-07,9,PHI,LAC,Away,331,445,155,356,1,2,176,89,2,1,0,0
2021-11-14,10,DEN,PHI,Away,308,386,212,170,0,2,96,216,1,0,1,1
2021-11-21,11,PHI,NOR,Home,380,323,138,214,0,3,242,109,3,1,1,1
2021-11-28,12,NYG,PHI,Home,264,332,194,124,1,0,70,208,0,1,4,4
2021-12-05,13,NYJ,PHI,Away,281,418,211,233,2,2,70,185,1,1,0,0
2021-12-21,15,PHI,WAS,Home,519,237,281,174,1,0,238,63,2,2,2,2
2021-12-26,16,PHI,NYG,Home,324,192,194,108,2,1,130,84,1,0,0,0
2022-01-02,17,WAS,PHI,Away,312,330,218,212,0,0,94,118,1,2,0,0
2022-01-08,18,PHI,DAL,Away,315,475,166,304,2,5,149,171,1,2,1,1
2022-09-11,1,DET,PHI,Away,386,455,205,239,2,0,181,216,3,4,0,0
2022-09-19,2,PHI,MIN,Home,486,264,323,202,1,1,163,62,2,0,1,1
2022-09-25,3,WAS,PHI,Away,240,400,153,328,0,3,87,72,1,0,0,0
2022-10-02,4,PHI,JAX,Home,401,219,191,148,0,2,210,71,4,0,1,1
2022-10-09,5,ARI,PHI,Away,363,357,239,218,1,0,124,139,1,2,0,0
2022-10-16,6,PHI,DAL,Home,268,315,132,181,2,1,136,134,1,1,0,0
2022-10-30,8,PHI,PIT,Home,401,302,290,158,4,1,111,144,1,0,0,0
2022-11-03,9,HOU,PHI,Away,303,360,135,217,2,2,168,143,0,2,1,1
2022-11-14,10,PHI,WAS,Away,264,330,170,178,2,0,94,152,1,2,4,4
2022-11-20,11,IND,PHI,Away,284,314,185,173,0,1,99,141,1,1,2,2
2022-11-27,12,PHI,GNB,Home,500,342,137,236,2,3,363,106,3,1,1,1
2022-12-04,13,PHI,TEN,Home,453,209,386,122,3,1,67,87,2,0,0,0
2022-12-11,14,NYG,PHI,Away,304,437,181,184,2,2,123,253,1,4,0,0
2022-12-18,15,CHI,PHI,Away,248,421,91,309,2,0,157,112,1,3,3,3
2022-12-24,16,DAL,PHI,Home,419,442,304,355,3,2,115,87,1,1,4,4
2023-01-01,17,PHI,NOR,Away,313,313,246,184,1,0,67,129,0,1,1,1
2023-01-08,18,PHI,NYG,Home,342,284,207,155,0,1,135,129,1,1,1,1
2023-09-10,1,NWE,PHI,Away,382,251,306,154,3,1,76,97,0,0,1,1
2023-09-14,2,PHI,MIN,Home,430,374,171,346,1,4,259,28,3,0,1,1
2023-09-25,3,TAM,PHI,Away,174,472,133,271,1,1,41,201,0,1,2,2
2023-10-01,4,PHI,WAS,Home,415,365,311,258,2,1,104,107,1,2,0,0
2023-10-08,5,LAR,PHI,Away,249,454,195,295,2,1,54,159,0,1,1,1
2023-10-15,6,NYJ,PHI,Home,244,348,155,268,0,1,89,80,1,1,4,4
2023-10-22,7,PHI,MIA,Home,355,244,256,199,2,1,99,45,2,0,2,2
2023-10-29,8,WAS,PHI,Away,472,374,388,315,4,4,84,59,0,1,2,2
2023-11-05,9,PHI,DAL,Home,292,406,183,333,2,3,109,73,2,0,0,0
2023-11-20,11,KAN,PHI,Away,336,238,168,124,2,0,168,114,0,3,1,1
2023-11-26,12,PHI,BUF,Home,378,505,193,332,3,2,185,173,2,2,2,2
2023-12-03,13,PHI,SFO,Away,333,456,287,310,1,4,46,146,1,2,0,0
2023-12-10,14,DAL,PHI,Home,394,324,256,218,2,0,138,106,1,0,3,3
2023-12-18,15,SEA,PHI,Home,297,321,197,143,1,0,100,178,1,2,2,2
2023-12-25,16,PHI,NYG,Home,465,292,295,186,1,1,170,106,2,1,2,2
2023-12-31,17,PHI,ARI,Away,275,449,184,228,3,3,91,221,0,1,1,1
2024-01-07,18,NYG,PHI,Home,415,299,306,166,1,1,109,133,2,0,4,4
2014-09-07,1,PIT,CLE,Home,503,389,376,198,1,1,127,191,2,2,1,1
2014-09-11,2,BAL,PIT,Home,323,301,166,202,2,0,157,99,0,0,3,3
2014-09-21,3,CAR,PIT,Away,349,454,307,190,2,2,42,264,0,1,0,0
2014-09-28,4,PIT,TAM,Away,390,350,305,287,3,2,85,63,0,1,1,1
2014-10-05,5,JAX,PIT,Away,243,372,187,261,0,1,56,111,0,0,1,1
2014-10-12,6,CLE,PIT,Home,368,359,210,221,1,1,158,138,3,0,1,1
2014-10-20,7,PIT,HOU,Home,328,393,252,261,3,2,76,132,0,0,1,1
2014-10-26,8,PIT,IND,Home,639,448,522,385,6,3,117,63,0,1,2,2
2014-11-02,9,PIT,BAL,Home,376,332,321,269,6,2,55,63,0,0,1,1
2014-11-09,10,NYJ,PIT,Home,275,362,125,326,2,1,150,36,0,0,4,4
2014-11-17,11,TEN,PIT,Away,312,386,263,180,2,1,49,206,1,1,1,1
2014-11-30,13,PIT,NOR,Away,538,393,435,250,2,5,103,143,1,0,2,2
2014-12-07,14,CIN,PIT,Away,408,543,322,350,2,3,86,193,1,2,0,0
2014-12-14,15,ATL,PIT,Away,407,398,310,353,2,0,97,45,0,2,0,0
2014-12-21,16,PIT,KAN,Home,282,327,214,288,1,0,68,39,1,0,0,0
2014-12-28,17,PIT,CIN,Home,346,337,317,221,2,2,29,116,0,0,3,3
2015-09-10,1,NWE,PIT,Home,361,464,281,330,4,1,80,134,0,1,1,1
2015-09-20,2,PIT,SFO,Home,453,409,369,298,3,2,84,111,3,0,0,0
2015-09-27,3,LAR,PIT,Away,258,259,187,197,0,0,71,62,0,1,1,1
2015-10-01,4,PIT,BAL,Away,263,356,96,165,1,1,167,191,1,1,0,0
2015-10-12,5,LAC,PIT,Away,406,349,354,194,2,1,52,155,0,1,1,1
2015-10-18,6,PIT,ARI,Home,310,469,169,414,2,1,141,55,0,0,0,0
2015-10-25,7,KAN,PIT,Home,377,339,239,192,1,1,138,147,1,0,3,3
2015-11-01,8,PIT,CIN,Away,356,296,240,218,1,1,116,78,0,0,3,3
2015-11-08,9,PIT,LVR,Home,597,440,402,301,2,4,195,139,2,1,2,2
2015-11-15,10,PIT,CLE,Home,459,342,399,327,3,1,60,15,0,0,2,2
2015-11-29,12,SEA,PIT,Home,436,538,336,480,5,1,100,58,1,2,4,4
2015-12-06,13,PIT,IND,Home,522,240,364,186,4,1,158,54,0,0,2,2
2015-12-13,14,CIN,PIT,Away,385,354,321,270,2,0,64,84,0,2,1,1
2015-12-20,15,PIT,DEN,Home,377,385,354,281,3,3,23,104,1,1,2,2
2015-12-27,16,BAL,PIT,Home,386,308,265,198,1,0,121,110,1,2,3,3
2016-01-03,17,CLE,PIT,Away,263,379,177,349,0,3,86,30,0,0,3,3
2016-09-12,1,WAS,PIT,Away,384,437,329,290,0,3,55,147,1,2,1,1
2016-09-18,2,PIT,CIN,Home,374,412,250,366,3,1,124,46,0,0,2,2
2016-09-25,3,PHI,PIT,Home,426,251,301,222,2,0,125,29,2,0,2,2
2016-10-02,4,PIT,KAN,Home,436,357,287,270,5,2,149,87,1,0,0,0
2016-10-09,5,PIT,NYJ,Home,436,316,375,244,4,1,61,72,0,0,1,1
2016-10-16,6,MIA,PIT,Home,474,297,252,169,0,1,222,128,3,1,2,2
2016-10-23,7,PIT,NWE,Away,375,362,281,222,1,2,94,140,0,2,1,1
2016-11-06,9,BAL,PIT,Home,274,277,224,241,1,1,50,36,0,1,1,1
2016-11-13,10,PIT,DAL,Away,448,422,400,295,3,2,48,127,1,2,0,0
2016-11-20,11,CLE,PIT,Away,209,313,176,167,1,0,33,146,0,1,0,0
2016-11-24,12,IND,PIT,Away,310,369,219,221,1,3,91,148,0,1,0,0
2016-12-04,13,PIT,NYG,Home,389,234,272,178,2,2,117,56,0,0,2,2
2016-12-11,14,BUF,PIT,Away,275,460,208,220,2,0,67,240,1,3,3,3
2016-12-18,15,CIN,PIT,Away,222,382,146,285,0,1,76,97,2,0,0,0
2016-12-25,16,PIT,BAL,Home,406,368,279,246,3,1,127,122,1,1,2,2
2017-01-01,17,PIT,CLE,Home,312,437,243,206,3,2,69,231,1,1,1,1
2017-09-10,1,CLE,PIT,Away,237,290,180,255,1,2,57,35,1,0,1,1
2017-09-17,2,PIT,MIN,Home,335,237,233,146,2,0,102,91,0,1,0,0
2017-09-24,3,CHI,PIT,Home,306,282,84,212,1,1,222,70,2,1,2,2
2017-10-01,4,BAL,PIT,Away,288,381,206,208,1,1,82,173,0,2,1,1
2017-10-08,5,PIT,JAX,Away,371,313,301,82,0,0,70,231,0,2,5,5
2017-10-15,6,KAN,PIT,Away,251,439,223,245,1,1,28,194,0,1,1,1
2017-10-22,7,PIT,CIN,Home,420,179,268,108,2,2,152,71,0,0,0,0
2017-10-29,8,DET,PIT,Away,482,392,411,317,0,1,71,75,0,1,2,2
2017-11-12,10,IND,PIT,Away,267,316,196,228,2,2,71,88,0,0,1,1
2017-11-16,11,PIT,TEN,Home,349,316,284,264,4,1,65,52,0,1,0,0
2017-11-26,12,PIT,GNB,Home,462,307,341,227,4,3,121,80,0,1,3,3
2017-12-04,13,CIN,PIT,Away,353,374,223,282,2,2,130,92,0,0,1,1
2017-12-10,14,PIT,BAL,Home,545,413,486,261,2,2,59,152,2,3,0,0
2017-12-17,15,PIT,NWE,Away,413,360,270,283,2,1,143,77,1,2,1,1
2017-12-25,16,HOU,PIT,Away,227,330,51,226,1,2,176,104,0,2,0,0
2017-12-31,17,PIT,CLE,Home,348,374,224,272,1,2,124,102,2,1,2,2
2018-09-09,1,CLE,PIT,Home,327,472,150,313,1,1,177,159,2,2,6,6
2018-09-16,2,PIT,KAN,Away,475,449,442,322,3,6,33,127,2,0,0,0
2018-09-24,3,TAM,PIT,Away,455,413,392,335,3,3,63,78,0,0,1,1
2018-09-30,4,PIT,BAL,Away,284,451,265,355,1,2,19,96,0,0,2,2
2018-10-07,5,PIT,ATL,Home,381,324,250,262,3,1,131,62,2,1,1,1
2018-10-14,6,CIN,PIT,Away,275,481,213,369,2,1,62,112,1,2,0,0
2018-10-28,8,PIT,CLE,Home,421,237,253,163,2,2,168,74,2,0,2,2
2018-11-04,9,BAL,PIT,Away,265,395,204,282,0,2,61,113,1,1,0,0
2018-11-08,10,PIT,CAR,Home,457,242,319,147,5,2,138,95,1,1,0,0
2018-11-18,11,JAX,PIT,Away,243,323,64,297,0,2,179,26,1,1,3,3
2018-11-25,12,DEN,PIT,Home,308,527,184,452,2,2,124,75,1,0,4,4
2018-12-02,13,PIT,LAC,Away,336,371,271,286,2,2,65,85,2,1,1,1
2018-12-09,14,LVR,PIT,Home,354,340,299,300,2,2,55,40,1,1,1,1
2018-12-16,15,PIT,NWE,Home,376,368,218,272,2,1,158,96,0,0,2,2
2018-12-23,16,NOR,PIT,Home,370,429,313,364,1,3,57,65,3,0,2,2
2018-12-30,17,PIT,CIN,Home,343,196,278,71,1,0,65,125,0,0,1,1
2019-09-08,1,NWE,PIT,Home,465,308,366,276,3,0,99,32,0,0,1,1
2019-09-15,2,PIT,SEA,Away,261,425,180,274,2,3,81,151,1,1,1,1
2019-09-22,3,SFO,PIT,Home,436,239,268,160,1,2,168,79,2,0,2,2
2019-09-30,4,PIT,CIN,Home,326,175,260,102,2,0,66,73,1,0,1,1
2019-10-06,5,PIT,BAL,Away,269,277,192,139,1,1,77,138,1,1,2,2
2019-10-13,6,LAC,PIT,Away,348,256,316,132,2,1,32,124,0,1,1,1
2019-10-28,8,PIT,MIA,Home,394,230,236,170,2,2,158,60,1,0,1,1
2019-11-03,9,PIT,IND,Home,273,328,183,189,1,3,90,139,0,0,2,2
2019-11-10,10,PIT,LAR,Home,273,306,231,218,1,0,42,88,0,0,2,2
2019-11-14,11,CLE,PIT,Home,293,236,189,178,2,1,104,58,1,0,4,4
2019-11-24,12,CIN,PIT,Away,244,338,158,179,1,1,86,159,0,0,1,1
2019-12-01,13,PIT,CLE,Home,323,279,199,173,1,1,124,106,1,0,1,1
2019-12-08,14,ARI,PIT,Away,236,275,165,135,2,1,71,140,0,0,2,2
2019-12-15,15,PIT,BUF,Away,229,261,178,131,1,1,51,130,0,1,5,5
2019-12-22,16,NYJ,PIT,Home,259,260,174,185,1,1,85,75,0,0,2,2
2019-12-29,17,BAL,PIT,Home,304,168,81,77,0,0,223,91,1,1,2,2
2020-09-14,1,NYG,PIT,Away,291,349,262,208,2,3,29,141,0,0,1,1
2020-09-20,2,PIT,DEN,Home,410,319,301,215,2,2,109,104,1,0,2,2
2020-09-27,3,PIT,HOU,Home,387,260,218,231,2,2,169,29,1,1,0,0
2020-10-11,5,PIT,PHI,Home,367,336,231,242,3,2,136,94,2,2,1,1
2020-10-18,6,PIT,CLE,Home,277,220,148,145,1,1,129,75,3,0,0,0
2020-10-25,7,TEN,PIT,Away,292,362,210,268,2,2,82,94,1,1,3,3
2020-11-01,8,BAL,PIT,Away,457,221,192,173,2,2,265,48,1,1,1,1
2020-11-08,9,DAL,PIT,Away,364,355,220,309,1,3,144,46,0,0,0,0
2020-11-15,10,PIT,CIN,Home,377,324,333,185,4,1,44,139,0,0,0,0
2020-11-22,11,JAX,PIT,Away,206,373,133,267,0,2,73,106,0,1,1,1
2020-12-02,12,PIT,BAL,Home,334,219,266,90,1,1,68,129,0,1,2,2
2020-12-07,13,PIT,WAS,Away,326,318,305,273,2,1,21,45,0,1,1,1
2020-12-13,14,BUF,PIT,Home,334,224,230,177,2,2,104,47,0,0,2,2
2020-12-21,15,CIN,PIT,Home,230,244,78,158,1,1,152,86,2,1,3,3
2020-12-27,16,PIT,IND,Home,354,365,332,238,3,1,22,127,1,2,0,0
2021-01-03,17,CLE,PIT,Home,358,394,166,309,1,2,192,85,2,0,1,1
2021-09-12,1,BUF,PIT,Away,371,252,254,177,1,1,117,75,0,0,0,0
2021-09-19,2,PIT,LVR,Away,331,425,292,373,1,2,39,52,1,0,1,1
2021-09-26,3,PIT,CIN,Away,342,268,297,172,1,3,45,96,0,0,2,2
2021-10-03,4,GNB,PIT,Home,367,282,236,220,2,1,131,62,1,1,2,2
2021-10-10,5,PIT,DEN,Home,391,374,244,268,2,2,147,106,1,0,1,1
2021-10-17,6,PIT,SEA,Home,345,309,226,165,1,1,119,144,1,1,1,1
2021-10-31,8,CLE,PIT,Away,306,370,210,255,0,1,96,115,1,1,0,0
2021-11-08,9,PIT,CHI,Home,280,414,175,278,2,1,105,136,1,1,1,1
2021-11-14,10,PIT,DET,Away,387,306,242,77,1,0,145,229,0,2,3,3
2021-11-21,11,LAC,PIT,Home,533,300,374,245,3,3,159,55,2,1,0,0
2021-11-28,12,CIN,PIT,Home,370,301,172,250,1,1,198,51,3,0,3,3
2021-12-05,13,PIT,BAL,Home,321,326,236,219,2,1,85,107,0,1,0,0
2021-12-09,14,MIN,PIT,Home,458,375,216,269,2,3,242,106,2,1,1,1
2021-12-19,15,PIT,TEN,Home,168,318,133,117,0,0,35,201,1,1,0,0
2021-12-26,16,KAN,PIT,Home,381,303,254,173,3,1,127,130,1,0,3,3
2022-01-03,17,PIT,CLE,Home,299,232,109,139,1,2,190,93,1,0,1,1
2022-01-09,18,BAL,PIT,Away,381,314,132,235,0,1,249,79,1,0,1,1
2022-09-11,1,CIN,PIT,Away,432,267,299,192,2,1,133,75,0,0,0,0
2022-09-18,2,PIT,NWE,Away,243,376,152,252,1,1,91,124,0,1,2,2
2022-09-22,3,CLE,PIT,Home,376,308,205,204,2,0,171,104,1,2,1,1
2022-10-02,4,PIT,NYJ,Away,297,348,178,250,0,2,119,98,2,1,4,4
2022-10-09,5,BUF,PIT,Home,552,364,432,310,4,0,120,54,1,0,2,2
2022-10-16,6,PIT,TAM,Home,270,304,193,229,2,1,77,75,0,0,0,0
2022-10-23,7,MIA,PIT,Home,372,341,261,246,1,1,111,95,0,0,3,3
2022-10-30,8,PHI,PIT,Home,401,302,290,158,4,1,111,144,1,0,2,2
2022-11-13,10,PIT,NOR,Home,379,186,162,157,0,1,217,29,2,0,0,0
2022-11-20,11,PIT,CIN,Away,351,408,249,346,1,4,102,62,2,0,0,0
2022-11-28,12,IND,PIT,Away,290,323,180,151,1,0,110,172,1,2,0,0
2022-12-04,13,ATL,PIT,Away,306,351,160,197,1,1,146,154,0,0,0,0
2022-12-11,14,PIT,BAL,Away,329,309,264,94,1,0,65,215,1,1,3,3
2022-12-18,15,CAR,PIT,Away,209,325,188,169,1,0,21,156,0,3,0,0
2022-12-24,16,PIT,LVR,Home,350,201,244,143,1,1,106,58,0,0,1,1
2023-01-01,17,BAL,PIT,Away,240,351,120,153,1,1,120,198,0,0,0,0
2023-01-08,18,PIT,CLE,Home,333,307,189,173,1,2,144,134,2,0,1,1
2023-09-10,1,PIT,SFO,Away,239,391,198,203,1,2,41,188,0,1,2,2
2023-09-18,2,PIT,CLE,Home,255,408,200,210,1,1,55,198,0,1,2,2
2023-09-24,3,LVR,PIT,Away,362,333,293,228,2,2,69,105,0,0,0,0
2023-10-01,4,HOU,PIT,Home,451,225,312,111,3,0,139,114,0,0,1,1
2023-10-08,5,PIT,BAL,Home,289,335,202,210,1,0,87,125,0,1,1,1
2023-10-22,7,LAR,PIT,Away,354,300,219,214,1,0,135,86,1,3,0,0
2023-10-29,8,PIT,JAX,Away,261,377,191,271,1,1,70,106,0,0,2,2
2023-11-02,9,PIT,TEN,Home,326,340,160,235,1,0,166,105,1,1,0,0
2023-11-12,10,PIT,GNB,Home,324,399,119,283,0,2,205,116,2,0,0,0
2023-11-19,11,CLE,PIT,Home,259,249,163,77,0,0,96,172,1,1,0,0
2023-11-26,12,CIN,PIT,Away,222,421,197,268,1,0,25,153,0,1,1,1
2023-12-03,13,PIT,ARI,Away,317,282,187,132,1,1,130,150,0,2,1,1
2023-12-07,14,PIT,NWE,Away,264,303,182,222,1,3,82,81,1,0,1,1
2023-12-16,15,IND,PIT,Home,372,216,202,142,3,1,170,74,0,1,3,3
2023-12-23,16,PIT,CIN,Home,397,368,284,309,2,1,113,59,2,0,0,0
2023-12-31,17,SEA,PIT,Away,369,468,281,266,1,0,88,202,1,3,0,0
2024-01-06,18,BAL,PIT,Away,224,289,118,134,1,1,106,155,0,1,2,2
2014-09-04,1,SEA,GNB,Home,398,255,191,175,2,1,207,80,2,1,1,1
2014-09-14,2,LAC,SEA,Home,377,288,276,180,3,2,101,108,0,1,1,1
2014-09-21,3,SEA,DEN,Home,384,332,255,296,2,2,129,36,1,0,1,1
2014-10-06,5,WAS,SEA,Away,307,403,275,178,2,2,32,225,0,1,0,0
2014-10-12,6,SEA,DAL,Away,206,401,126,239,0,2,80,162,1,1,1,1
2014-10-19,7,LAR,SEA,Home,275,463,173,292,2,2,102,171,1,1,0,0
2014-10-26,8,CAR,SEA,Away,266,310,152,191,0,1,114,119,0,0,2,2
2014-11-02,9,SEA,LVR,Home,326,226,177,189,0,2,149,37,2,0,0,0
2014-11-09,10,SEA,NYG,Home,510,324,160,270,0,1,350,54,5,1,3,3
2014-11-16,11,KAN,SEA,Home,298,372,108,168,0,2,190,204,3,0,0,0
2014-11-23,12,SEA,ARI,Home,293,204,169,140,1,0,124,64,0,0,0,0
2014-11-27,13,SFO,SEA,Away,164,379,100,222,0,1,64,157,0,0,0,0
2014-12-07,14,PHI,SEA,Away,139,440,82,252,2,2,57,188,0,1,2,2
2014-12-14,15,SEA,SFO,Home,290,245,138,105,1,0,152,140,1,1,1,1
2014-12-21,16,ARI,SEA,Away,216,596,187,329,0,2,29,267,0,3,0,0
2014-12-28,17,SEA,LAR,Home,354,245,222,203,0,0,132,42,1,0,2,2
2015-09-13,1,LAR,SEA,Home,352,343,276,219,1,1,76,124,2,0,1,1
2015-09-20,2,GNB,SEA,Home,361,324,234,205,2,2,127,119,0,0,2,2
2015-09-27,3,SEA,CHI,Home,371,146,212,48,1,0,159,98,0,0,0,0
2015-10-05,4,SEA,DET,Home,345,256,235,203,1,0,110,53,0,0,3,3
2015-10-11,5,CIN,SEA,Home,419,397,310,197,2,1,109,200,1,1,1,1
2015-10-18,6,SEA,CAR,Away,334,383,219,248,1,1,115,135,1,3,0,0
2015-10-22,7,SFO,SEA,Away,142,388,81,212,0,1,61,176,0,1,2,2
2015-11-01,8,DAL,SEA,Away,220,323,91,210,0,1,129,113,0,0,1,1
2015-11-15,10,SEA,ARI,Away,343,451,228,334,1,3,115,117,2,1,1,1
2015-11-22,11,SEA,SFO,Home,508,306,253,247,3,1,255,59,1,0,0,0
2015-11-29,12,SEA,PIT,Home,436,538,336,480,5,1,100,58,1,2,0,0
2015-12-06,13,MIN,SEA,Away,125,433,94,260,0,3,31,173,0,2,1,1
2015-12-13,14,BAL,SEA,Away,302,424,274,301,0,5,28,123,0,0,1,1
2015-12-20,15,SEA,CLE,Home,423,230,241,136,3,1,182,94,0,0,0,0
2015-12-27,16,SEA,LAR,Away,312,205,253,103,2,1,59,102,0,1,3,3
2016-01-03,17,ARI,SEA,Away,232,354,205,209,1,3,27,145,0,1,0,0
2016-09-11,1,SEA,MIA,Home,352,214,240,150,1,0,112,64,0,1,2,2
2016-09-18,2,LAR,SEA,Home,283,306,219,239,0,0,64,67,0,0,1,1
2016-09-25,3,SEA,SFO,Home,418,254,291,119,2,0,127,135,2,2,2,2
2016-10-02,4,NYJ,SEA,Away,305,354,247,288,1,3,58,66,0,0,0,0
2016-10-16,6,SEA,ATL,Home,333,362,261,310,0,3,72,52,3,0,0,0
2016-10-23,7,ARI,SEA,Home,443,257,311,205,0,0,132,52,0,0,0,0
2016-10-30,8,NOR,SEA,Home,375,359,252,285,1,0,123,74,1,1,1,1
2016-11-07,9,SEA,BUF,Home,278,425,245,263,2,1,33,162,2,2,0,0
2016-11-13,10,NWE,SEA,Away,385,420,304,324,0,3,81,96,3,0,0,0
2016-11-20,11,SEA,PHI,Home,439,308,287,195,2,2,152,113,1,0,0,0
2016-11-27,12,TAM,SEA,Home,338,245,220,118,2,0,118,127,0,0,3,3
2016-12-04,13,SEA,CAR,Home,534,271,294,182,1,1,240,89,3,0,1,1
2016-12-11,14,GNB,SEA,Home,330,354,237,218,3,1,93,136,2,0,6,6
2016-12-15,15,SEA,LAR,Home,299,183,227,136,3,0,72,47,0,0,1,1
2016-12-24,16,SEA,ARI,Away,391,370,313,276,4,1,78,94,0,3,1,1
2017-01-01,17,SFO,SEA,Away,253,376,191,289,1,1,62,87,2,1,0,0
2017-09-10,1,GNB,SEA,Home,370,225,286,135,1,0,84,90,1,0,1,1
2017-09-17,2,SEA,SFO,Home,312,248,181,89,1,0,131,159,0,0,0,0
2017-09-24,3,TEN,SEA,Home,420,433,225,364,2,4,195,69,1,0,0,0
2017-10-01,4,SEA,IND,Home,477,237,283,139,2,1,194,98,2,1,2,2
2017-10-08,5,LAR,SEA,Away,375,241,275,179,0,1,100,62,1,0,2,2
2017-10-22,7,NYG,SEA,Away,177,425,131,321,1,3,46,104,0,0,1,1
2017-10-29,8,SEA,HOU,Home,479,509,446,367,4,4,33,142,0,1,1,1
2017-11-05,9,SEA,WAS,Away,437,244,289,193,2,0,148,51,0,2,2,2
2017-11-09,10,ARI,SEA,Away,290,287,256,212,1,2,34,75,1,0,0,0
2017-11-20,11,SEA,ATL,Away,360,279,224,190,2,2,136,89,1,1,2,2
2017-11-26,12,SFO,SEA,Away,280,318,196,228,1,2,84,90,0,1,1,1
2017-12-03,13,SEA,PHI,Home,310,425,209,327,3,1,101,98,0,0,0,0
2017-12-10,14,JAX,SEA,Home,424,401,268,260,2,3,156,141,1,0,3,3
2017-12-17,15,SEA,LAR,Away,149,352,71,108,1,2,78,244,0,3,2,2
2017-12-24,16,DAL,SEA,Away,282,136,154,60,0,2,128,76,0,0,0,0
2017-12-31,17,SEA,ARI,Away,296,259,195,143,2,1,101,116,0,1,0,0
2018-09-09,1,DEN,SEA,Home,470,306,324,242,3,3,146,64,0,0,3,3
2018-09-17,2,CHI,SEA,Home,271,276,185,202,2,2,86,74,0,0,2,2
2018-09-23,3,SEA,DAL,Home,295,303,182,137,2,1,113,166,1,0,0,0
2018-09-30,4,ARI,SEA,Away,263,331,171,160,1,0,92,171,1,2,0,0
2018-10-07,5,SEA,LAR,Away,373,468,183,313,3,1,190,155,1,3,0,0
2018-10-14,6,LVR,SEA,Away,185,369,106,214,0,3,79,155,0,0,1,1
2018-10-28,8,DET,SEA,Away,331,413,297,237,2,3,34,176,0,1,0,0
2018-11-04,9,SEA,LAC,Away,356,375,202,215,2,2,154,160,0,1,1,1
2018-11-11,10,LAR,SEA,Home,456,414,307,141,2,3,149,273,2,1,1,1
2018-11-15,11,SEA,GNB,Home,378,359,205,311,2,2,173,48,1,1,1,1
2018-11-25,12,CAR,SEA,Away,476,397,256,322,2,2,220,75,1,1,0,0
2018-12-02,13,SEA,SFO,Home,331,452,163,386,4,2,168,66,1,0,0,0
2018-12-10,14,SEA,MIN,Home,274,276,60,199,0,1,214,77,1,0,1,1
2018-12-16,15,SFO,SEA,Home,351,385,257,217,1,2,94,168,0,1,0,0
2018-12-23,16,SEA,KAN,Home,464,419,254,265,3,3,210,154,2,0,0,0
2018-12-30,17,SEA,ARI,Home,291,198,109,113,1,1,182,85,2,0,1,1
2019-09-08,1,SEA,CIN,Home,232,429,160,395,2,2,72,34,1,0,1,1
2019-09-15,2,PIT,SEA,Away,261,425,180,274,2,3,81,151,1,1,2,2
2019-09-22,3,SEA,NOR,Away,514,265,406,177,2,2,108,88,2,1,1,1
2019-09-29,4,ARI,SEA,Away,321,340,206,225,0,1,115,115,1,1,0,0
2019-10-03,5,SEA,LAR,Home,429,477,262,395,4,1,167,82,0,2,1,1
2019-10-13,6,CLE,SEA,Away,406,454,249,284,1,2,157,170,3,2,1,1
2019-10-20,7,SEA,BAL,Away,347,340,241,141,1,0,106,199,0,1,2,2
2019-10-27,8,ATL,SEA,Away,510,322,441,171,1,2,69,151,1,1,0,0
2019-11-03,9,SEA,TAM,Home,492,418,347,319,5,2,145,99,0,2,1,1
2019-11-11,10,SFO,SEA,Away,302,336,215,189,1,1,87,147,0,1,4,4
2019-11-24,12,PHI,SEA,Away,344,348,238,174,1,1,106,174,0,1,2,2
2019-12-02,13,SEA,MIN,Home,444,354,226,276,2,2,218,78,2,1,2,2
2019-12-08,14,LAR,SEA,Home,455,308,293,202,2,0,162,106,2,0,1,1
2019-12-15,15,CAR,SEA,Away,414,428,269,274,1,2,145,154,2,2,1,1
2019-12-22,16,SEA,ARI,Away,224,412,133,159,1,1,91,253,0,2,1,1
2019-12-29,17,SEA,SFO,Away,348,398,223,270,2,0,125,128,1,3,0,0
2020-09-13,1,ATL,SEA,Away,506,383,434,299,2,4,72,84,1,1,0,0
2020-09-20,2,SEA,NWE,Home,429,464,275,397,5,1,154,67,0,2,1,1
2020-09-27,3,SEA,DAL,Home,412,522,295,461,5,3,117,61,0,1,1,1
2020-10-04,4,MIA,SEA,Away,415,441,312,343,0,2,103,98,1,2,1,1
2020-10-11,5,SEA,MIN,Home,314,449,190,248,3,2,124,201,1,1,1,1
2020-10-25,7,ARI,SEA,Home,519,572,360,372,3,3,159,200,1,1,3,3
2020-11-01,8,SEA,SFO,Home,350,351,249,299,4,2,101,52,1,2,0,0
2020-11-08,9,BUF,SEA,Home,420,419,386,362,3,2,34,57,2,2,4,4
2020-11-15,10,LAR,SEA,Home,389,333,283,220,0,0,106,113,3,1,3,3
2020-11-19,11,SEA,ARI,Home,347,314,182,257,2,2,165,57,1,1,0,0
2020-11-30,12,PHI,SEA,Away,250,301,180,225,2,1,70,76,0,1,0,0
2020-12-06,13,SEA,NYG,Away,327,290,216,100,1,1,111,190,0,1,2,2
2020-12-13,14,SEA,NYJ,Home,410,185,236,116,4,0,174,69,1,0,1,1
2020-12-20,15,WAS,SEA,Away,353,302,269,121,1,1,84,181,1,1,1,1
2020-12-27,16,SEA,LAR,Home,292,334,197,216,1,0,95,118,1,0,0,0
2021-01-03,17,SFO,SEA,Away,328,280,242,159,1,2,86,121,1,1,0,0
2021-09-12,1,IND,SEA,Away,336,381,223,241,2,4,113,140,0,0,1,1
2021-09-19,2,SEA,TEN,Away,397,532,320,320,2,0,77,212,2,3,0,0
2021-09-26,3,MIN,SEA,Home,453,389,313,283,3,1,140,106,0,1,0,0
2021-10-03,4,SFO,SEA,Away,457,234,314,129,3,2,143,105,0,2,0,0
2021-10-07,5,SEA,LAR,Away,354,476,262,358,2,1,92,118,0,2,2,2
2021-10-17,6,PIT,SEA,Home,345,309,226,165,1,1,119,144,1,1,1,1
2021-10-25,7,SEA,NOR,Away,219,304,129,210,1,1,90,94,0,0,0,0
2021-10-31,8,SEA,JAX,Home,229,309,160,227,2,1,69,82,1,0,0,0
2021-11-14,10,GNB,SEA,Home,393,208,287,133,0,0,106,75,2,0,2,2
2021-11-21,11,SEA,ARI,Away,266,413,180,318,0,2,86,95,1,1,0,0
2021-11-29,12,WAS,SEA,Home,371,267,219,233,1,2,152,34,1,0,1,1
2021-12-05,13,SEA,SFO,Home,327,365,181,294,2,2,146,71,2,1,3,3
2021-12-12,14,HOU,SEA,Away,380,453,317,260,1,2,63,193,0,2,0,0
2021-12-21,15,LAR,SEA,Home,332,214,209,134,2,0,123,80,0,1,1,1
2021-12-26,16,SEA,CHI,Away,331,317,161,229,2,1,170,88,1,2,0,0
2022-01-02,17,SEA,DET,Home,497,357,232,262,4,2,265,95,2,2,0,0
2022-01-09,18,ARI,SEA,Away,305,431,187,229,1,3,118,202,1,2,2,2
2022-09-12,1,SEA,DEN,Home,253,433,177,330,2,1,76,103,0,0,1,1
2022-09-18,2,SFO,SEA,Home,373,216,184,180,1,0,189,36,2,0,3,3
2022-09-25,3,SEA,ATL,Away,420,386,308,207,2,1,112,179,0,2,1,1
2022-10-02,4,DET,SEA,Away,520,555,375,320,4,2,145,235,2,3,1,1
2022-10-09,5,NOR,SEA,Home,438,396,203,245,2,3,235,151,3,1,1,1
2022-10-16,6,SEA,ARI,Home,296,315,160,171,0,0,136,144,1,0,1,1
2022-10-23,7,LAC,SEA,Away,329,404,276,191,2,2,53,213,1,2,2,2
2022-10-30,8,SEA,NYG,Home,277,225,190,147,2,0,87,78,1,1,1,1
2022-11-06,9,ARI,SEA,Away,262,421,140,263,2,2,122,158,0,2,1,1
2022-11-13,10,TAM,SEA,Home,419,283,258,244,2,2,161,39,1,0,1,1
2022-11-27,12,SEA,LVR,Away,372,576,307,293,2,3,65,283,2,2,2,2
2022-12-04,13,LAR,SEA,Away,319,438,148,348,0,3,171,90,2,0,2,2
2022-12-11,14,SEA,CAR,Away,287,328,241,105,3,1,46,223,0,2,2,2
2022-12-15,15,SEA,SFO,Away,277,381,207,211,1,2,70,170,0,1,1,1
2022-12-24,16,KAN,SEA,Home,297,333,220,200,2,1,77,133,1,0,1,1
2023-01-01,17,SEA,NYJ,Home,346,279,148,204,2,0,198,75,0,0,0,0
2023-01-08,18,SEA,LAR,Home,402,269,205,123,1,0,197,146,0,1,2,2
2023-09-10,1,SEA,LAR,Away,180,426,95,334,1,0,85,92,0,3,0,0
2023-09-17,2,DET,SEA,Away,418,393,316,311,3,2,102,82,1,2,0,0
2023-09-24,3,SEA,CAR,Home,425,378,279,334,1,2,146,44,2,1,1,1
2023-10-02,4,NYG,SEA,Away,248,281,136,160,0,1,112,121,0,1,0,0
2023-10-15,6,CIN,SEA,Home,214,384,168,297,2,0,46,87,0,1,2,2
2023-10-22,7,SEA,ARI,Home,318,249,203,122,2,0,115,127,0,1,3,3
2023-10-29,8,SEA,CLE,Home,362,385,248,230,2,1,114,155,1,1,2,2
2023-11-05,9,BAL,SEA,Home,515,151,217,123,1,0,298,28,3,0,2,2
2023-11-12,10,SEA,WAS,Home,489,356,369,288,2,3,120,68,0,0,0,0
2023-11-19,11,LAR,SEA,Home,267,291,185,223,1,1,82,68,1,0,1,1
2023-11-23,12,SEA,SFO,Away,220,377,132,208,0,1,88,169,0,3,2,2
2023-11-30,13,DAL,SEA,Home,411,406,275,334,3,3,136,72,1,2,1,1
2023-12-10,14,SFO,SEA,Home,527,324,354,254,2,2,173,70,2,0,2,2
2023-12-18,15,SEA,PHI,Home,297,321,197,143,1,0,100,178,1,2,0,0
2023-12-24,16,TEN,SEA,Away,287,273,125,215,1,2,162,58,1,0,0,0
2023-12-31,17,SEA,PIT,Away,369,468,281,266,1,0,88,202,1,3,1,1
2024-01-07,18,ARI,SEA,Away,466,327,260,189,1,2,206,138,1,0,0,0
2014-09-07,1,DAL,SFO,Away,382,319,255,192,1,2,127,127,1,1,0,0
2014-09-14,2,SFO,CHI,Away,359,216,232,170,1,4,127,46,1,0,4,4
2014-09-21,3,ARI,SFO,Home,338,318,254,236,2,1,84,82,0,1,0,0
2014-09-28,4,SFO,PHI,Home,407,213,189,191,2,0,218,22,0,0,1,1
2014-10-05,5,SFO,KAN,Home,357,265,186,158,1,1,171,107,0,1,0,0
2014-10-13,6,LAR,SFO,Away,309,432,216,343,1,3,93,89,1,0,1,1
2014-10-19,7,DEN,SFO,Home,419,310,304,248,4,2,115,62,2,0,1,1
2014-11-02,9,SFO,LAR,Away,263,193,183,102,1,1,80,91,0,0,2,2
2014-11-09,10,NOR,SFO,Away,423,330,287,186,3,1,136,144,0,2,1,1
2014-11-16,11,NYG,SFO,Away,330,333,265,185,1,1,65,148,0,0,1,1
2014-11-23,12,SFO,WAS,Home,312,213,246,77,1,0,66,136,1,1,3,3
2014-11-27,13,SFO,SEA,Away,164,379,100,222,0,1,64,157,0,0,3,3
2014-12-07,14,LVR,SFO,Home,330,248,245,151,3,1,85,97,0,0,2,2
2014-12-14,15,SEA,SFO,Home,290,245,138,105,1,0,152,140,1,1,0,0
2014-12-20,16,SFO,LAC,Away,447,446,92,348,1,4,355,98,3,0,3,3
2014-12-28,17,SFO,ARI,Home,395,397,189,299,2,2,206,98,0,0,0,0
2015-09-14,1,SFO,MIN,Home,395,248,165,177,0,0,230,71,2,0,1,1
2015-09-20,2,PIT,SFO,Home,453,409,369,298,3,2,84,111,3,0,1,1
2015-09-27,3,ARI,SFO,Home,446,156,307,53,2,0,139,103,2,1,4,4
2015-10-04,4,SFO,GNB,Away,196,362,119,200,0,1,77,162,0,1,1,1
2015-10-11,5,NYG,SFO,Home,525,380,441,256,3,2,84,124,0,1,0,0
2015-10-18,6,SFO,BAL,Home,391,420,326,343,2,2,65,77,0,0,0,0
2015-10-22,7,SFO,SEA,Away,142,388,81,212,0,1,61,176,0,1,0,0
2015-11-01,8,LAR,SFO,Home,388,189,191,151,1,0,197,38,2,0,0,0
2015-11-08,9,SFO,ATL,Home,318,302,185,285,2,1,133,17,0,0,2,2
2015-11-22,11,SEA,SFO,Home,508,306,253,247,3,1,255,59,1,0,0,0
2015-11-29,12,SFO,ARI,Away,368,337,301,267,1,0,67,70,0,2,2,2
2015-12-06,13,CHI,SFO,Away,364,291,194,170,0,1,170,121,2,2,0,0
2015-12-13,14,CLE,SFO,Home,481,221,251,150,1,1,230,71,2,0,0,0
2015-12-20,15,SFO,CIN,Away,318,242,263,174,1,1,55,68,1,2,4,4
2015-12-27,16,DET,SFO,Home,371,322,284,201,2,2,87,121,1,0,1,1
2016-01-03,17,SFO,LAR,Home,458,364,350,231,1,0,108,133,0,1,1,1
2016-09-12,1,SFO,LAR,Home,320,185,170,120,1,0,150,65,3,0,1,1
2016-09-18,2,CAR,SFO,Home,529,302,353,237,4,2,176,65,0,1,3,3
2016-09-25,3,SEA,SFO,Home,418,254,291,119,2,0,127,135,2,2,1,1
2016-10-02,4,SFO,DAL,Away,295,428,189,234,1,2,106,194,1,1,1,1
2016-10-06,5,SFO,ARI,Away,286,288,135,116,1,2,151,172,2,2,3,3
2016-10-16,6,BUF,SFO,Home,492,300,179,167,2,1,313,133,4,0,1,1
2016-10-23,7,SFO,TAM,Away,273,513,113,264,1,3,160,249,1,1,3,3
2016-11-06,9,SFO,NOR,Away,486,571,393,323,2,3,93,248,0,2,4,4
2016-11-13,10,ARI,SFO,Home,443,281,363,198,1,1,80,83,1,1,1,1
2016-11-20,11,SFO,NWE,Away,299,444,177,273,2,4,122,171,0,0,0,0
2016-11-27,12,MIA,SFO,Home,358,475,263,282,3,3,95,193,1,0,2,2
2016-12-04,13,CHI,SFO,Home,326,147,184,6,0,0,142,141,3,0,0,0
2016-12-11,14,SFO,NYJ,Away,364,404,116,216,1,0,248,188,1,2,0,0
2016-12-18,15,ATL,SFO,Home,550,272,302,165,2,2,248,107,3,0,1,1
2016-12-24,16,LAR,SFO,Away,177,323,78,253,1,2,99,70,2,1,2,2
2017-01-01,17,SFO,SEA,Away,253,376,191,289,1,1,62,87,2,1,2,2
2017-09-10,1,SFO,CAR,Away,217,287,166,171,0,2,51,116,0,0,2,2
2017-09-17,2,SEA,SFO,Home,312,248,181,89,1,0,131,159,0,0,1,1
2017-09-21,3,SFO,LAR,Away,421,418,308,292,2,3,113,126,3,2,2,2
2017-10-01,4,ARI,SFO,Home,368,305,317,210,1,0,51,95,0,0,1,1
2017-10-08,5,IND,SFO,Home,447,402,288,336,0,2,159,66,2,0,0,0
2017-10-15,6,WAS,SFO,Home,419,335,325,250,2,1,94,85,1,2,1,1
2017-10-22,7,SFO,DAL,Away,290,501,187,236,0,3,103,265,1,3,3,3
2017-10-29,8,PHI,SFO,Home,304,238,192,144,2,1,112,94,1,0,2,2
2017-11-05,9,SFO,ARI,Away,329,368,266,201,0,2,63,167,1,0,2,2
2017-11-12,10,SFO,NYG,Home,474,374,288,260,2,2,186,114,2,0,2,2
2017-11-26,12,SFO,SEA,Away,280,318,196,228,1,2,84,90,0,1,1,1
2017-12-03,13,CHI,SFO,Away,147,388,85,278,1,0,62,110,0,0,1,1
2017-12-10,14,HOU,SFO,Away,311,416,221,314,2,1,90,102,0,1,1,1
2017-12-17,15,SFO,TEN,Home,414,328,363,238,1,2,51,90,0,0,0,0
2017-12-24,16,SFO,JAX,Home,369,472,238,380,2,2,131,92,3,2,1,1
2017-12-31,17,LAR,SFO,Away,251,461,149,292,0,2,102,169,1,2,3,3
2018-09-09,1,MIN,SFO,Home,343,327,227,237,2,1,116,90,0,0,4,4
2018-09-16,2,SFO,DET,Home,346,427,156,329,2,3,190,98,1,0,0,0
2018-09-23,3,KAN,SFO,Home,384,406,307,228,3,2,77,178,2,1,0,0
2018-09-30,4,LAC,SFO,Home,368,364,242,288,3,2,126,76,0,0,2,2
2018-10-07,5,SFO,ARI,Away,447,220,300,164,2,1,147,56,1,2,5,5
2018-10-15,6,GNB,SFO,Home,521,401,405,227,2,2,116,174,1,1,3,3
2018-10-21,7,SFO,LAR,Away,228,339,121,193,1,2,107,146,0,2,4,4
2018-10-28,8,ARI,SFO,Home,321,267,233,160,2,1,88,107,0,0,0,0
2018-11-01,9,SFO,LVR,Home,405,242,262,140,3,0,143,102,1,0,0,0
2018-11-12,10,SFO,NYG,Away,374,277,250,180,1,3,124,97,1,0,2,2
2018-11-25,12,TAM,SFO,Home,412,342,304,194,2,1,108,148,1,0,2,2
2018-12-02,13,SEA,SFO,Home,331,452,163,386,4,2,168,66,1,0,3,3
2018-12-09,14,SFO,DEN,Home,389,274,305,171,2,1,84,103,0,1,1,1
2018-12-16,15,SFO,SEA,Home,351,385,257,217,1,2,94,168,0,1,1,1
2018-12-23,16,SFO,CHI,Away,279,325,232,235,0,1,47,90,0,1,1,1
2018-12-30,17,LAR,SFO,Home,377,391,222,264,4,3,155,127,1,1,4,4
2019-09-08,1,TAM,SFO,Away,295,256,174,158,1,1,121,98,0,0,2,2
2019-09-15,2,CIN,SFO,Away,316,571,291,312,2,3,25,259,0,2,1,1
2019-09-22,3,SFO,PIT,Home,436,239,268,160,1,2,168,79,2,0,5,5
2019-10-07,5,SFO,CLE,Home,446,180,171,78,2,0,275,102,2,0,0,0
2019-10-13,6,LAR,SFO,Away,157,331,48,232,0,0,109,99,1,2,2,2
2019-10-20,7,WAS,SFO,Away,154,283,50,146,0,0,104,137,0,0,1,1
2019-10-27,8,SFO,CAR,Home,388,230,156,100,2,0,232,130,5,1,1,1
2019-10-31,9,ARI,SFO,Away,357,411,204,310,2,4,153,101,1,0,0,0
2019-11-11,10,SFO,SEA,Away,302,336,215,189,1,1,87,147,0,1,3,3
2019-11-17,11,SFO,ARI,Home,442,266,408,131,4,2,34,135,0,1,2,2
2019-11-24,12,SFO,GNB,Home,339,198,227,81,2,1,112,117,2,0,0,0
2019-12-01,13,BAL,SFO,Home,283,331,105,157,1,1,178,174,1,1,1,1
2019-12-08,14,NOR,SFO,Away,465,516,349,354,5,5,116,162,1,1,1,1
2019-12-15,15,SFO,ATL,Away,313,290,193,201,1,2,120,89,1,1,2,2
2019-12-21,16,SFO,LAR,Home,334,395,215,323,1,2,119,72,2,2,2,2
2019-12-29,17,SEA,SFO,Away,348,398,223,270,2,0,125,128,1,3,0,0
2020-09-13,1,SFO,ARI,Away,366,404,243,224,2,1,123,180,0,2,0,0
2020-09-20,2,NYJ,SFO,Away,277,359,173,177,1,2,104,182,0,2,1,1
2020-09-27,3,NYG,SFO,Away,231,420,165,327,0,1,66,93,0,3,0,0
2020-10-04,4,SFO,PHI,Away,417,267,301,174,1,1,116,93,2,1,3,3
2020-10-11,5,SFO,MIA,Away,259,436,128,342,1,3,131,94,1,1,3,3
2020-10-18,6,SFO,LAR,Home,390,311,268,198,3,2,122,113,0,0,0,0
2020-10-25,7,NWE,SFO,Away,241,467,147,270,0,0,94,197,0,4,2,2
2020-11-01,8,SEA,SFO,Home,350,351,249,299,4,2,101,52,1,2,2,2
2020-11-05,9,SFO,GNB,Away,337,405,282,294,1,4,55,111,1,0,2,2
2020-11-15,10,NOR,SFO,Home,237,281,123,232,1,1,114,49,2,0,4,4
2020-11-29,12,LAR,SFO,Away,308,345,182,233,0,0,126,112,1,1,3,3
2020-12-07,13,SFO,BUF,Away,402,449,316,368,3,4,86,81,0,0,2,2
2020-12-13,14,SFO,WAS,Away,344,193,236,95,1,0,108,98,1,0,3,3
2020-12-20,15,DAL,SFO,Home,291,458,204,308,2,3,87,150,2,1,4,4
2020-12-26,16,ARI,SFO,Away,350,398,230,171,0,3,120,227,1,0,1,1
2021-01-03,17,SFO,SEA,Away,328,280,242,159,1,2,86,121,1,1,1,1
2021-09-12,1,DET,SFO,Away,430,442,314,311,3,2,116,131,1,2,2,2
2021-09-19,2,PHI,SFO,Away,328,306,177,189,0,1,151,117,1,1,0,0
2021-09-26,3,SFO,GNB,Away,298,353,231,253,2,2,67,100,2,1,2,2
2021-10-03,4,SFO,SEA,Away,457,234,314,129,3,2,143,105,0,2,2,2
2021-10-10,5,ARI,SFO,Home,304,338,210,186,1,0,94,152,1,1,1,1
2021-10-24,7,SFO,IND,Away,280,295,169,147,1,2,111,148,1,2,4,4
2021-10-31,8,CHI,SFO,Away,324,467,148,322,1,0,176,145,1,3,0,0
2021-11-07,9,SFO,ARI,Away,337,437,298,274,2,1,39,163,0,3,3,3
2021-11-15,10,SFO,LAR,Home,335,278,179,226,2,1,156,52,1,0,0,0
2021-11-21,11,JAX,SFO,Away,200,333,146,162,0,2,54,171,1,1,0,0
2021-11-28,12,SFO,MIN,Home,423,323,215,256,1,2,208,67,3,1,1,1
2021-12-05,13,SEA,SFO,Home,327,365,181,294,2,2,146,71,2,1,3,3
2021-12-12,14,CIN,SFO,Away,397,355,311,255,2,2,86,100,0,1,0,0
2021-12-19,15,SFO,ATL,Home,397,275,235,213,1,1,162,62,3,0,1,1
2021-12-23,16,TEN,SFO,Home,278,389,188,306,1,1,90,83,1,1,2,2
2022-01-02,17,SFO,HOU,Home,416,222,241,136,2,1,175,86,0,0,1,1
2022-01-09,18,LAR,SFO,Away,265,449,201,314,3,2,64,135,0,1,2,2
2022-09-11,1,CHI,SFO,Home,204,331,105,155,2,0,99,176,1,1,2,2
2022-09-18,2,SFO,SEA,Home,373,216,184,180,1,0,189,36,2,0,0,0
2022-09-25,3,DEN,SFO,Home,261,267,160,179,0,1,101,88,1,0,3,3
2022-10-03,4,SFO,LAR,Home,327,257,239,200,1,0,88,57,1,0,0,0
2022-10-09,5,CAR,SFO,Away,308,397,244,244,0,2,64,153,1,2,1,1
2022-10-16,6,ATL,SFO,Home,289,346,121,296,2,2,168,50,1,0,3,3
2022-10-23,7,SFO,KAN,Away,444,529,343,417,2,3,101,112,0,3,3,3
2022-10-30,8,LAR,SFO,Away,223,368,167,257,1,3,56,111,1,1,0,0
2022-11-13,10,SFO,LAC,Home,387,238,230,187,0,1,157,51,2,0,1,1
2022-11-21,11,ARI,SFO,Away,314,387,247,228,0,4,67,159,1,1,0,0
2022-11-27,12,SFO,NOR,Home,317,260,221,197,1,0,96,63,0,0,0,0
2022-12-04,13,SFO,MIA,Home,351,308,230,275,2,2,121,33,0,0,1,1
2022-12-11,14,SFO,TAM,Home,404,322,195,253,2,1,209,69,3,0,1,1
2022-12-15,15,SEA,SFO,Away,277,381,207,211,1,2,70,170,0,1,0,0
2022-12-24,16,SFO,WAS,Home,371,349,218,270,2,3,153,79,2,0,1,1
2023-01-01,17,LVR,SFO,Away,500,454,365,284,3,2,135,170,1,2,1,1
2023-01-08,18,SFO,ARI,Home,311,255,142,194,3,1,169,61,2,1,0,0
2023-09-10,1,PIT,SFO,Away,239,391,198,203,1,2,41,188,0,1,1,1
2023-09-17,2,LAR,SFO,Away,386,365,297,206,1,0,89,159,1,3,0,0
2023-09-21,3,SFO,NYG,Home,441,150,300,121,2,0,141,29,1,1,0,0
2023-10-01,4,SFO,ARI,Home,395,362,271,257,1,2,124,105,4,0,0,0
2023-10-08,5,SFO,DAL,Home,421,197,251,140,4,1,170,57,2,0,1,1
2023-10-15,6,CLE,SFO,Home,334,215,174,107,0,1,160,108,1,1,1,1
2023-10-23,7,MIN,SFO,Home,452,325,378,260,2,1,74,65,0,1,3,3
2023-10-29,8,SFO,CIN,Away,460,400,347,266,1,3,113,134,1,1,3,3
2023-11-12,10,JAX,SFO,Away,221,437,162,293,0,3,59,144,0,1,0,0
2023-11-19,11,SFO,TAM,Home,420,287,305,221,3,1,115,66,0,1,0,0
2023-11-23,12,SEA,SFO,Away,220,377,132,208,0,1,88,169,0,3,1,1
2023-12-03,13,PHI,SFO,Away,333,456,287,310,1,4,46,146,1,2,0,0
2023-12-10,14,SFO,SEA,Home,527,324,354,254,2,2,173,70,2,0,2,2
2023-12-17,15,ARI,SFO,Away,436,406,202,262,1,4,234,144,2,1,0,0
2023-12-25,16,SFO,BAL,Away,429,343,308,241,1,2,121,102,1,1,5,5
2023-12-31,17,WAS,SFO,Away,225,408,163,224,1,2,62,184,0,1,0,0
2024-01-07,18,SFO,LAR,Away,300,258,175,149,1,2,125,109,2,1,1,1
2014-09-07,1,TAM,CAR,Away,264,334,162,221,2,2,102,113,0,0,3,3
2014-09-14,2,TAM,LAR,Away,332,339,175,220,0,0,157,119,2,1,1,1
2014-09-18,3,ATL,TAM,Home,488,217,344,153,3,1,144,64,3,0,5,5
2014-09-28,4,PIT,TAM,Away,390,350,305,287,3,2,85,63,0,1,1,1
2014-10-05,5,NOR,TAM,Home,511,314,371,248,2,2,140,66,2,1,1,1
2014-10-12,6,TAM,BAL,Away,364,475,277,306,2,5,87,169,0,1,1,1
2014-10-26,8,TAM,MIN,Away,225,332,159,235,1,1,66,97,0,0,2,2
2014-11-02,9,CLE,TAM,Home,330,365,274,252,2,2,56,113,0,0,2,2
2014-11-09,10,TAM,ATL,Away,373,322,281,212,2,1,92,110,0,1,3,3
2014-11-16,11,WAS,TAM,Away,322,329,167,281,1,2,155,48,0,0,1,1
2014-11-23,12,CHI,TAM,Home,204,367,112,301,1,1,92,66,2,0,4,4
2014-11-30,13,TAM,CIN,Away,263,288,188,176,0,1,75,112,1,1,1,1
2014-12-07,14,DET,TAM,Home,407,233,294,207,3,2,113,26,1,0,3,3
2014-12-14,15,CAR,TAM,Home,392,287,269,136,1,1,123,151,0,1,3,3
2014-12-21,16,TAM,GNB,Away,109,431,93,310,0,1,16,121,0,1,1,1
2014-12-28,17,TAM,NOR,Away,280,338,97,268,1,1,183,70,1,2,1,1
2015-09-13,1,TAM,TEN,Away,273,309,181,185,2,4,92,124,0,1,2,2
2015-09-20,2,NOR,TAM,Away,323,333,219,194,1,1,104,139,2,1,2,2
2015-09-27,3,HOU,TAM,Home,413,318,227,261,1,1,186,57,1,0,1,1
2015-10-04,4,TAM,CAR,Away,411,244,270,111,2,2,141,133,1,0,5,5
2015-10-11,5,TAM,JAX,Home,369,325,186,270,1,4,183,55,2,0,0,0
2015-10-25,7,WAS,TAM,Home,355,479,305,289,3,2,50,190,1,0,1,1
2015-11-01,8,ATL,TAM,Away,496,290,395,173,2,1,101,117,0,1,0,0
2015-11-08,9,TAM,NYG,Away,383,327,247,213,0,2,136,114,1,0,3,3
2015-11-15,10,TAM,DAL,Home,330,228,246,186,0,0,84,42,1,0,2,2
2015-11-22,11,PHI,TAM,Away,383,521,247,238,2,5,136,283,0,0,1,1
2015-11-29,12,IND,TAM,Home,336,344,309,212,2,1,27,132,0,0,1,1
2015-12-06,13,TAM,ATL,Home,388,319,222,255,1,1,166,64,2,0,2,2
2015-12-13,14,TAM,NOR,Away,291,388,176,301,1,2,115,87,1,1,0,0
2015-12-17,15,LAR,TAM,Home,319,509,221,363,2,2,98,146,2,0,2,2
2015-12-27,16,TAM,CHI,Away,389,327,285,153,2,1,104,174,1,1,3,3
2016-01-03,17,CAR,TAM,Home,366,386,255,309,2,0,111,77,3,1,3,3
2016-09-11,1,ATL,TAM,Away,374,371,322,281,2,4,52,90,0,0,1,1
2016-09-18,2,ARI,TAM,Home,416,306,311,221,3,1,105,85,1,0,5,5
2016-09-25,3,TAM,LAR,Away,472,320,389,183,3,2,83,137,1,2,2,2
2016-10-02,4,TAM,DEN,Away,215,307,143,218,0,2,72,89,1,1,3,3
2016-10-10,5,CAR,TAM,Away,414,315,278,202,0,1,136,113,2,0,0,0
2016-10-23,7,SFO,TAM,Away,273,513,113,264,1,3,160,249,1,1,1,1
2016-10-30,8,TAM,LVR,Away,270,626,168,498,2,4,102,128,1,0,0,0
2016-11-03,9,TAM,ATL,Away,396,461,326,325,4,4,70,136,0,1,2,2
2016-11-13,10,TAM,CHI,Home,360,283,280,161,2,1,80,122,1,0,1,1
2016-11-20,11,KAN,TAM,Away,343,442,261,326,1,1,82,116,1,0,1,1
2016-11-27,12,TAM,SEA,Home,338,245,220,118,2,0,118,127,0,0,2,2
2016-12-04,13,LAC,TAM,Away,330,349,211,268,2,1,119,81,1,1,1,1
2016-12-11,14,TAM,NOR,Home,270,294,166,248,0,0,104,46,1,0,0,0
2016-12-18,15,DAL,TAM,Home,449,276,264,224,0,2,185,52,2,0,4,4
2016-12-24,16,NOR,TAM,Home,417,349,294,260,1,2,123,89,2,1,2,2
2017-01-01,17,TAM,CAR,Home,300,335,188,207,1,1,112,128,0,1,2,2
2017-09-17,2,TAM,CHI,Home,311,310,194,290,1,1,117,20,1,0,1,1
2017-09-24,3,MIN,TAM,Home,494,342,369,316,3,2,125,26,1,0,3,3
2017-10-01,4,TAM,NYG,Home,434,379,323,288,3,2,111,91,0,1,0,0
2017-10-05,5,TAM,NWE,Away,409,402,319,289,1,1,90,113,1,0,0,0
2017-10-15,6,ARI,TAM,Home,432,412,272,344,3,3,160,68,2,1,2,2
2017-10-22,7,BUF,TAM,Home,434,447,261,378,1,3,173,69,2,0,3,3
2017-10-29,8,TAM,CAR,Away,279,254,194,154,0,1,85,100,0,1,3,3
2017-11-05,9,NOR,TAM,Home,407,200,256,113,2,1,151,87,1,0,1,1
2017-11-12,10,TAM,NYJ,Home,271,275,181,219,1,1,90,56,0,0,1,1
2017-11-19,11,MIA,TAM,Away,448,321,365,268,2,2,83,53,0,0,0,0
2017-11-26,12,ATL,TAM,Home,516,373,368,279,2,0,148,94,2,2,0,0
2017-12-03,13,GNB,TAM,Home,276,395,77,230,0,2,199,165,2,0,1,1
2017-12-10,14,TAM,DET,Away,400,434,267,381,2,1,133,53,1,2,5,5
2017-12-18,15,TAM,ATL,Away,373,410,289,209,3,1,84,201,0,1,1,1
2017-12-24,16,CAR,TAM,Home,255,392,140,326,0,1,115,66,1,0,3,3
2017-12-31,17,TAM,NOR,Home,455,323,345,231,1,1,110,92,2,1,3,3
2018-09-09,1,NOR,TAM,Away,475,529,432,417,3,4,43,112,2,1,0,0
2018-09-16,2,TAM,PHI,Home,436,412,393,321,4,1,43,91,0,2,2,2
2018-09-24,3,TAM,PIT,Away,455,413,392,335,3,3,63,78,0,0,4,4
2018-09-30,4,CHI,TAM,Home,483,311,344,251,6,1,139,60,0,0,3,3
2018-10-14,6,ATL,TAM,Home,417,510,347,389,3,4,70,121,1,0,2,2
2018-10-21,7,TAM,CLE,Home,456,305,342,186,0,2,114,119,3,1,4,4
2018-10-28,8,CIN,TAM,Home,402,576,264,450,2,3,138,126,2,1,4,4
2018-11-04,9,CAR,TAM,Home,407,301,228,219,2,4,179,82,4,0,2,2
2018-11-11,10,TAM,WAS,Away,501,286,398,170,0,1,103,116,0,0,4,4
2018-11-18,11,NYG,TAM,Home,359,510,196,359,2,2,163,151,2,2,4,4
2018-11-25,12,TAM,SFO,Home,412,342,304,194,2,1,108,148,1,0,0,0
2018-12-02,13,TAM,CAR,Home,315,444,220,276,2,2,95,168,1,0,1,1
2018-12-09,14,TAM,NOR,Away,279,298,174,198,2,1,105,100,0,2,1,1
2018-12-16,15,BAL,TAM,Home,370,241,128,156,1,0,242,85,1,1,1,1
2018-12-23,16,DAL,TAM,Home,232,383,152,320,1,1,80,63,1,1,2,2
2018-12-30,17,TAM,ATL,Away,433,489,341,380,4,3,92,109,0,1,1,1
2019-09-08,1,TAM,SFO,Away,295,256,174,158,1,1,121,98,0,0,4,4
2019-09-12,2,CAR,TAM,Away,352,289,313,189,0,1,39,100,0,1,0,0
2019-09-22,3,TAM,NYG,Away,499,384,355,312,3,2,144,72,0,2,1,1
2019-09-29,4,LAR,TAM,Away,518,464,490,376,2,4,28,88,2,2,1,1
2019-10-06,5,NOR,TAM,Home,457,252,345,158,4,2,112,94,0,1,0,0
2019-10-13,6,TAM,CAR,Away,407,268,365,209,1,2,42,59,2,2,7,7
2019-10-27,8,TEN,TAM,Home,246,389,174,283,3,2,72,106,0,0,4,4
2019-11-03,9,SEA,TAM,Home,492,418,347,319,5,2,145,99,0,2,1,1
2019-11-10,10,TAM,ARI,Home,457,417,339,342,1,3,118,75,2,0,3,3
2019-11-17,11,TAM,NOR,Away,334,328,298,219,2,3,36,109,0,0,4,4
2019-11-24,12,ATL,TAM,Away,337,446,280,313,1,3,57,133,1,1,2,2
2019-12-01,13,JAX,TAM,Away,242,315,193,241,1,0,49,74,0,2,1,1
2019-12-08,14,TAM,IND,Home,542,309,467,243,4,2,75,66,1,1,4,4
2019-12-15,15,DET,TAM,Away,295,495,250,446,0,4,45,49,2,0,1,1
2019-12-21,16,TAM,HOU,Away,435,229,329,161,1,0,106,68,1,1,5,5
2019-12-29,17,TAM,ATL,Away,329,373,193,286,2,1,136,87,0,0,3,3
2020-09-13,1,NOR,TAM,Home,271,310,189,224,2,2,82,86,1,1,3,3
2020-09-20,2,TAM,CAR,Home,339,427,217,340,1,0,122,87,3,2,2,2
2020-09-27,3,DEN,TAM,Away,226,353,184,285,1,3,42,68,0,0,0,0
2020-10-04,4,TAM,LAC,Home,484,324,369,278,5,3,115,46,0,0,1,1
2020-10-08,5,CHI,TAM,Home,243,339,208,233,1,1,35,106,1,0,1,1
2020-10-18,6,TAM,GNB,Home,324,201,166,107,2,0,158,94,2,1,0,0
2020-10-25,7,LVR,TAM,Away,347,454,271,369,2,4,76,85,0,2,0,0
2020-11-02,8,NYG,TAM,Away,357,344,256,263,2,2,101,81,1,0,1,1
2020-11-08,9,TAM,NOR,Away,194,420,186,282,0,4,8,138,0,1,3,3
2020-11-15,10,CAR,TAM,Away,187,544,122,334,2,3,65,210,1,2,1,1
2020-11-23,11,TAM,LAR,Away,251,413,209,376,2,3,42,37,1,0,2,2
2020-11-29,12,TAM,KAN,Away,417,543,342,456,3,3,75,87,0,0,2,2
2020-12-13,14,TAM,MIN,Home,303,335,196,173,2,1,107,162,1,1,0,0
2020-12-20,15,ATL,TAM,Away,369,416,332,365,3,2,37,51,0,2,0,0
2020-12-26,16,DET,TAM,Away,186,588,113,477,0,6,73,111,0,1,0,0
2021-01-03,17,TAM,ATL,Home,485,385,391,258,4,2,94,127,1,1,1,1
2021-09-09,1,TAM,DAL,Home,431,451,379,391,4,3,52,60,0,0,4,4
2021-09-19,2,TAM,ATL,Home,341,348,259,293,5,2,82,55,0,1,1,1
2021-09-26,3,LAR,TAM,Home,407,446,331,411,4,1,76,35,0,2,0,0
2021-10-10,5,TAM,MIA,Home,558,301,437,262,5,2,121,39,1,0,0,0
2021-10-14,6,PHI,TAM,Away,213,399,113,297,1,2,100,102,2,2,1,1
2021-10-24,7,TAM,CHI,Home,408,311,226,168,4,0,182,143,1,0,1,1
2021-10-31,8,NOR,TAM,Home,361,421,209,350,2,4,152,71,1,0,3,3
2021-11-14,10,WAS,TAM,Home,320,273,226,220,1,2,94,53,2,0,2,2
2021-11-22,11,TAM,NYG,Home,402,215,308,149,2,1,94,66,1,0,1,1
2021-11-28,12,IND,TAM,Away,392,359,285,217,3,1,107,142,1,4,2,2
2021-12-05,13,ATL,TAM,Away,380,425,259,368,0,4,121,57,1,0,1,1
2021-12-12,14,TAM,BUF,Home,488,466,351,293,2,2,137,173,2,1,0,0
2021-12-19,15,TAM,NOR,Away,302,212,184,151,0,0,118,61,0,0,2,2
2021-12-26,16,CAR,TAM,Away,273,391,206,232,0,1,67,159,0,2,0,0
2022-01-02,17,NYJ,TAM,Away,374,467,224,405,1,3,150,62,2,0,1,1
2022-01-09,18,TAM,CAR,Home,409,317,324,207,3,2,85,110,2,0,0,0
2022-09-11,1,DAL,TAM,Away,244,347,173,195,0,1,71,152,0,0,1,1
2022-09-18,2,NOR,TAM,Away,308,260,208,188,1,1,100,72,0,0,1,1
2022-09-25,3,TAM,GNB,Away,285,315,251,248,1,2,34,67,0,0,2,2
2022-10-02,4,TAM,KAN,Away,376,417,373,228,3,3,3,189,1,2,2,2
2022-10-09,5,TAM,ATL,Home,420,261,351,110,1,1,69,151,1,1,0,0
2022-10-16,6,PIT,TAM,Home,270,304,193,229,2,1,77,75,0,0,0,0
2022-10-23,7,CAR,TAM,Home,343,322,170,276,2,0,173,46,1,0,0,0
2022-10-27,8,TAM,BAL,Away,349,453,305,222,1,2,44,231,1,1,1,1
2022-11-06,9,TAM,LAR,Home,323,206,272,138,1,1,51,68,0,0,0,0
2022-11-13,10,TAM,SEA,Home,419,283,258,244,2,2,161,39,1,0,2,2
2022-11-27,12,CLE,TAM,Home,367,325,178,229,1,2,189,96,2,0,0,0
2022-12-05,13,TAM,NOR,Home,350,298,274,232,2,1,76,66,0,0,2,2
2022-12-11,14,SFO,TAM,Home,404,322,195,253,2,1,209,69,3,0,3,3
2022-12-18,15,TAM,CIN,Away,396,237,304,184,3,4,92,53,0,0,4,4
2022-12-25,16,ARI,TAM,Away,325,396,204,281,0,1,121,115,1,0,2,2
2023-01-01,17,TAM,CAR,Home,478,400,411,326,3,3,67,74,1,0,1,1
2023-01-08,18,ATL,TAM,Home,382,222,208,136,2,2,174,86,1,0,1,1
2023-09-10,1,MIN,TAM,Away,369,242,328,169,2,2,41,73,0,0,0,0
2023-09-17,2,TAM,CHI,Home,437,236,317,169,1,1,120,67,1,1,0,0
2023-09-25,3,TAM,PHI,Away,174,472,133,271,1,1,41,201,0,1,2,2
2023-10-01,4,NOR,TAM,Away,197,353,127,239,0,3,70,114,0,0,1,1
2023-10-15,6,TAM,DET,Away,251,380,205,340,0,2,46,40,0,0,1,1
2023-10-22,7,TAM,ATL,Away,329,401,256,245,1,0,73,156,0,1,2,2
2023-10-26,8,BUF,TAM,Home,427,302,312,224,2,2,115,78,1,0,0,0
2023-11-05,9,HOU,TAM,Home,496,332,443,251,5,2,53,81,0,2,1,1
2023-11-12,10,TAM,TEN,Home,340,209,263,167,2,0,77,42,0,0,1,1
2023-11-19,11,SFO,TAM,Home,420,287,305,221,3,1,115,66,0,1,2,2
2023-11-26,12,IND,TAM,Home,394,298,239,173,0,2,155,125,3,0,2,2
2023-12-03,13,TAM,CAR,Home,322,282,194,149,1,0,128,133,2,2,1,1
2023-12-10,14,ATL,TAM,Away,434,290,338,142,1,2,96,148,2,1,0,0
2023-12-17,15,GNB,TAM,Away,321,452,261,353,2,4,60,99,0,0,1,1
2023-12-24,16,TAM,JAX,Home,335,305,265,268,2,2,70,37,1,0,0,0
2023-12-31,17,TAM,NOR,Away,349,310,292,202,2,2,57,108,0,0,4,4
2024-01-07,18,CAR,TAM,Away,199,228,68,115,0,0,131,113,0,0,0,0
2014-09-07,1,KAN,TEN,Away,245,405,178,243,1,2,67,162,0,0,0,0
2014-09-14,2,TEN,DAL,Away,314,368,232,148,1,1,82,220,0,1,2,2
2014-09-21,3,CIN,TEN,Home,300,326,184,177,1,0,116,149,3,1,2,2
2014-09-28,4,IND,TEN,Home,498,261,393,176,4,1,105,85,1,1,3,3
2014-10-05,5,TEN,CLE,Away,410,460,261,284,3,3,149,176,1,0,0,0
2014-10-12,6,TEN,JAX,Home,290,379,220,297,0,1,70,82,1,1,0,0
2014-10-19,7,WAS,TEN,Home,351,236,251,160,1,2,100,76,0,0,2,2
2014-10-26,8,TEN,HOU,Away,326,405,290,193,2,1,36,212,0,2,2,2
2014-11-09,10,BAL,TEN,Home,312,210,161,143,1,1,151,67,2,0,2,2
2014-11-17,11,TEN,PIT,Away,312,386,263,180,2,1,49,206,1,1,1,1
2014-11-23,12,PHI,TEN,Home,462,351,298,299,1,2,164,52,2,1,3,3
2014-11-30,13,HOU,TEN,Home,457,320,358,237,6,2,99,83,0,0,4,4
2014-12-07,14,TEN,NYG,Away,207,402,146,260,0,1,61,142,0,1,3,3
2014-12-14,15,TEN,NYJ,Away,342,277,253,163,0,1,89,114,0,1,1,1
2014-12-18,16,JAX,TEN,Home,288,357,111,262,1,1,177,95,2,0,0,0
2014-12-28,17,TEN,IND,Away,192,378,50,314,1,3,142,64,0,0,1,1
2015-09-13,1,TAM,TEN,Away,273,309,181,185,2,4,92,124,0,1,1,1
2015-09-20,2,CLE,TEN,Home,274,385,158,219,2,2,116,166,1,0,3,3
2015-09-27,3,TEN,IND,Away,433,378,345,245,2,2,88,133,2,2,2,2
2015-10-11,5,TEN,BUF,Away,276,209,179,82,0,1,97,127,1,1,1,1
2015-10-18,6,TEN,MIA,Away,299,434,236,254,1,2,63,180,0,2,4,4
2015-10-25,7,TEN,ATL,Away,256,378,179,251,1,1,77,127,0,0,2,2
2015-11-01,8,HOU,TEN,Home,270,211,214,125,2,0,56,86,0,0,3,3
2015-11-08,9,NOR,TEN,Away,416,483,355,371,3,4,61,112,1,0,1,1
2015-11-15,10,TEN,CAR,Away,242,336,178,217,0,1,64,119,1,2,2,2
2015-11-19,11,JAX,TEN,Home,308,316,218,212,1,0,90,104,0,1,1,1
2015-11-29,12,TEN,LVR,Away,249,407,205,323,3,3,44,84,0,0,2,2
2015-12-06,13,TEN,JAX,Home,467,383,257,302,3,5,210,81,2,1,2,2
2015-12-13,14,NYJ,TEN,Home,439,292,256,268,3,1,183,24,0,0,1,1
2015-12-20,15,NWE,TEN,Home,346,282,253,223,2,2,93,59,0,0,3,3
2015-12-27,16,TEN,HOU,Away,257,330,227,202,1,2,30,128,0,1,4,4
2016-01-03,17,IND,TEN,Home,327,231,200,94,2,1,127,137,0,2,1,1
2016-09-11,1,TEN,MIN,Away,316,301,252,236,2,0,64,65,0,0,3,3
2016-09-18,2,DET,TEN,Away,375,363,238,224,1,2,137,139,0,0,1,1
2016-09-25,3,TEN,LVR,Away,393,368,212,245,0,1,181,123,1,1,3,3
2016-10-02,4,HOU,TEN,Home,359,320,244,196,2,0,115,124,0,2,1,1
2016-10-09,5,MIA,TEN,Away,200,398,149,163,0,3,51,235,1,1,0,0
2016-10-16,6,TEN,CLE,Home,407,341,270,301,3,2,137,40,1,1,1,1
2016-10-23,7,TEN,IND,Away,331,422,207,341,2,3,124,81,1,0,1,1
2016-10-27,8,TEN,JAX,Home,494,370,280,322,2,3,214,48,2,0,0,0
2016-11-06,9,LAC,TEN,Home,476,393,268,313,2,3,208,80,1,2,3,3
2016-11-13,10,TEN,GNB,Home,446,402,292,333,5,2,154,69,1,1,0,0
2016-11-20,11,IND,TEN,Home,327,351,251,254,2,2,76,97,1,0,0,0
2016-11-27,12,CHI,TEN,Away,411,375,316,226,3,2,95,149,0,1,0,0
2016-12-11,14,TEN,DEN,Home,253,348,73,330,0,1,180,18,1,0,0,0
2016-12-18,15,KAN,TEN,Away,316,389,159,241,0,0,157,148,2,2,3,3
2016-12-24,16,JAX,TEN,Home,415,263,331,205,2,2,84,58,1,0,1,1
2017-01-01,17,TEN,HOU,Home,236,289,133,243,1,1,103,46,1,1,1,1
2017-09-10,1,TEN,LVR,Away,350,359,255,250,0,2,95,109,1,0,0,0
2017-09-17,2,JAX,TEN,Away,310,390,211,211,1,1,99,179,1,3,1,1
2017-09-24,3,TEN,SEA,Home,420,433,225,364,2,4,195,69,1,0,0,0
2017-10-01,4,HOU,TEN,Home,445,195,272,109,4,0,173,86,2,2,5,5
2017-10-08,5,MIA,TEN,Home,178,188,78,119,1,1,100,69,0,0,2,2
2017-10-16,6,TEN,IND,Home,473,297,305,212,1,1,168,85,2,0,1,1
2017-10-22,7,CLE,TEN,Away,284,269,218,189,0,0,66,80,0,0,1,1
2017-11-05,9,TEN,BAL,Home,257,341,186,268,2,2,71,73,1,0,1,1
2017-11-12,10,TEN,CIN,Home,416,308,236,255,1,2,180,53,2,1,2,2
2017-11-16,11,PIT,TEN,Home,349,316,284,264,4,1,65,52,0,1,4,4
2017-11-26,12,IND,TEN,Away,254,276,165,184,0,1,89,92,1,1,2,2
2017-12-03,13,TEN,HOU,Home,344,384,146,331,1,1,198,53,2,0,1,1
2017-12-10,14,ARI,TEN,Home,261,204,125,139,0,0,136,65,0,1,2,2
2017-12-17,15,SFO,TEN,Home,414,328,363,238,1,2,51,90,0,0,1,1
2017-12-24,16,TEN,LAR,Away,366,402,269,286,0,4,97,116,1,0,1,1
2017-12-31,17,TEN,JAX,Home,232,229,116,146,1,0,116,83,0,0,1,1
2018-09-09,1,MIA,TEN,Home,342,336,222,220,2,0,120,116,0,1,3,3
2018-09-16,2,TEN,HOU,Home,283,437,183,289,2,2,100,148,0,0,0,0
2018-09-23,3,JAX,TEN,Away,232,233,145,83,0,0,87,150,0,0,0,0
2018-09-30,4,TEN,PHI,Home,397,432,327,315,2,2,70,117,1,0,1,1
2018-10-07,5,BUF,TEN,Home,223,221,79,121,0,0,144,100,1,0,3,3
2018-10-14,6,TEN,BAL,Away,106,361,51,238,0,1,55,123,0,2,0,0
2018-10-21,7,LAC,TEN,Home,344,390,297,226,2,1,47,164,0,1,1,1
2018-11-05,9,DAL,TEN,Away,297,340,225,215,2,2,72,125,0,2,2,2
2018-11-11,10,TEN,NWE,Home,385,284,235,244,2,0,150,40,2,1,0,0
2018-11-18,11,IND,TEN,Home,397,267,295,176,3,1,102,91,2,0,2,2
2018-11-26,12,HOU,TEN,Home,462,365,181,260,2,2,281,105,2,0,1,1
2018-12-02,13,TEN,NYJ,Home,403,280,273,124,2,0,130,156,1,0,1,1
2018-12-06,14,TEN,JAX,Home,426,255,162,195,0,1,264,60,4,0,1,1
2018-12-16,15,NYG,TEN,Away,260,301,213,86,0,0,47,215,0,2,0,0
2018-12-22,16,TEN,WAS,Home,291,292,192,131,1,1,99,161,1,0,0,0
2018-12-30,17,TEN,IND,Away,258,436,165,278,1,3,93,158,0,1,3,3
2019-09-08,1,CLE,TEN,Away,346,339,244,216,1,3,102,123,1,1,0,0
2019-09-15,2,TEN,IND,Away,243,288,119,121,1,3,124,167,1,0,0,0
2019-09-19,3,JAX,TEN,Home,292,340,204,249,2,0,88,91,0,1,1,1
2019-09-29,4,ATL,TEN,Away,422,365,364,227,0,3,58,138,1,0,0,0
2019-10-06,5,TEN,BUF,Away,252,313,150,204,0,2,102,109,1,0,0,0
2019-10-13,6,DEN,TEN,Home,270,204,167,165,0,0,103,39,1,0,3,3
2019-10-20,7,TEN,LAC,Home,403,365,306,326,2,2,97,39,1,0,1,1
2019-10-27,8,TEN,TAM,Home,246,389,174,283,3,2,72,106,0,0,1,1
2019-11-03,9,CAR,TEN,Home,370,431,214,310,2,1,156,121,2,2,3,3
2019-11-10,10,TEN,KAN,Home,371,530,146,433,2,3,225,97,2,0,1,1
2019-11-24,12,TEN,JAX,Home,471,369,252,252,2,0,219,117,4,2,2,2
2019-12-01,13,IND,TEN,Away,391,292,309,138,1,2,82,154,1,1,2,2
2019-12-08,14,LVR,TEN,Away,355,552,258,391,2,3,97,161,1,2,1,1
2019-12-15,15,TEN,HOU,Away,432,374,269,234,2,2,163,140,1,1,1,1
2019-12-22,16,TEN,NOR,Away,397,377,248,275,3,3,149,102,1,2,1,1
2019-12-29,17,HOU,TEN,Away,301,467,192,222,0,2,109,245,2,3,0,0
2020-09-14,1,DEN,TEN,Away,323,377,216,247,1,2,107,130,1,0,0,0
2020-09-20,2,TEN,JAX,Home,354,480,231,315,4,3,123,165,0,1,0,0
2020-09-27,3,MIN,TEN,Away,464,444,238,310,3,0,226,134,1,2,1,1
2020-10-13,5,TEN,BUF,Home,334,370,195,275,3,2,139,95,3,0,0,0
2020-10-18,6,TEN,HOU,Home,607,412,344,320,4,4,263,92,2,1,2,2
2020-10-25,7,TEN,PIT,Away,292,362,210,268,2,2,82,94,1,1,0,0
2020-11-01,8,CIN,TEN,Home,367,441,249,223,2,2,118,218,2,1,1,1
2020-11-08,9,TEN,CHI,Home,228,375,136,319,2,2,92,56,0,0,0,0
2020-11-12,10,TEN,IND,Away,294,430,137,297,1,1,157,133,1,2,0,0
2020-11-22,11,BAL,TEN,Away,306,423,177,250,1,2,129,173,1,1,1,1
2020-11-29,12,IND,TEN,Away,336,449,280,220,2,1,56,229,2,4,0,0
2020-12-06,13,TEN,CLE,Away,431,458,369,340,3,4,62,118,1,1,3,3
2020-12-13,14,JAX,TEN,Away,354,454,263,205,1,2,91,249,0,2,1,1
2020-12-20,15,TEN,DET,Home,463,430,268,307,3,1,195,123,3,2,0,0
2020-12-27,16,GNB,TEN,Home,448,260,214,104,4,1,234,156,2,1,2,2
2021-01-03,17,HOU,TEN,Away,457,492,361,204,3,1,96,288,1,4,1,1
2021-09-12,1,TEN,ARI,Away,248,416,162,280,1,4,86,136,1,1,3,3
2021-09-19,2,SEA,TEN,Away,397,532,320,320,2,0,77,212,2,3,1,1
2021-09-26,3,TEN,IND,Home,368,265,188,178,3,0,180,87,0,1,3,3
2021-10-03,4,NYJ,TEN,Home,355,430,289,253,2,1,66,177,1,1,0,0
2021-10-10,5,JAX,TEN,Away,454,368,256,184,1,1,198,184,2,3,0,0
2021-10-18,6,TEN,BUF,Home,362,417,216,335,0,3,146,82,4,0,1,1
2021-10-24,7,TEN,KAN,Home,369,334,266,257,2,0,103,77,1,0,1,1
2021-10-31,8,IND,TEN,Away,307,340,224,247,3,3,83,93,1,0,2,2
2021-11-07,9,LAR,TEN,Away,347,194,253,125,1,1,94,69,0,2,1,1
2021-11-14,10,TEN,NOR,Home,264,373,198,287,1,2,66,86,1,1,0,0
2021-11-21,11,TEN,HOU,Away,420,190,317,107,1,0,103,83,0,2,5,5
2021-11-28,12,NWE,TEN,Home,394,355,289,85,2,1,105,270,1,1,4,4
2021-12-12,14,TEN,JAX,Home,263,192,161,184,0,0,102,8,2,0,0,0
2021-12-19,15,PIT,TEN,Home,168,318,133,117,0,0,35,201,1,1,4,4
2021-12-23,16,TEN,SFO,Home,278,389,188,306,1,1,90,83,1,1,0,0
2022-01-02,17,TEN,MIA,Home,308,256,110,182,2,0,198,74,2,0,0,0
2022-01-09,18,HOU,TEN,Away,353,405,289,281,3,4,64,124,0,0,0,0
2022-09-11,1,TEN,NYG,Away,359,394,266,156,2,2,93,238,0,1,1,1
2022-09-19,2,BUF,TEN,Home,414,187,313,107,4,0,101,80,0,1,4,4
2022-09-25,3,TEN,LVR,Home,361,396,252,300,1,2,109,96,2,0,1,1
2022-10-02,4,IND,TEN,Away,365,243,327,116,2,2,38,127,0,1,0,0
2022-10-09,5,WAS,TEN,Away,385,241,342,136,2,1,43,105,0,2,0,0
2022-10-23,7,TEN,IND,Home,254,292,116,227,0,1,138,65,0,0,1,1
2022-10-30,8,HOU,TEN,Away,161,354,118,40,1,0,43,314,0,2,2,2
2022-11-06,9,KAN,TEN,Home,499,229,422,57,1,0,77,172,1,2,0,0
2022-11-13,10,TEN,DEN,Home,307,313,244,248,2,1,63,65,0,0,1,1
2022-11-17,11,GNB,TEN,Away,271,408,215,320,2,3,56,88,0,1,1,1
2022-11-27,12,TEN,CIN,Away,344,374,281,266,0,1,63,108,0,1,0,0
2022-12-04,13,PHI,TEN,Home,453,209,386,122,3,1,67,87,2,0,0,0
2022-12-11,14,TEN,JAX,Away,364,428,227,368,2,3,137,60,1,1,4,4
2022-12-18,15,LAC,TEN,Home,365,284,291,157,0,0,74,127,2,2,1,1
2022-12-24,16,TEN,HOU,Away,272,285,88,215,0,1,184,70,2,0,3,3
2022-12-29,17,TEN,DAL,Away,317,361,220,274,1,2,97,87,0,1,2,2
2023-01-07,18,JAX,TEN,Home,222,312,203,165,1,1,19,147,0,0,2,2
2023-09-10,1,NOR,TEN,Home,351,285,282,181,1,0,69,104,0,0,3,3
2023-09-17,2,TEN,LAC,Home,341,342,200,281,1,2,141,61,2,0,0,0
2023-09-24,3,CLE,TEN,Home,341,94,263,68,2,0,78,26,1,0,0,0
2023-10-01,4,TEN,CIN,Home,400,211,227,139,2,0,173,72,1,0,1,1
2023-10-08,5,IND,TEN,Home,429,348,236,259,0,0,193,89,2,1,1,1
2023-10-15,6,TEN,BAL,Away,233,360,104,221,0,1,129,139,1,0,2,2
2023-10-29,8,TEN,ATL,Home,375,342,226,202,4,1,149,140,0,1,1,1
2023-11-02,9,PIT,TEN,Home,326,340,160,235,1,0,166,105,1,1,1,1
2023-11-12,10,TAM,TEN,Home,340,209,263,167,2,0,77,42,0,0,1,1
2023-11-19,11,JAX,TEN,Home,389,235,261,143,2,2,128,92,2,0,2,2
2023-11-26,12,TEN,CAR,Home,264,258,184,162,0,0,80,96,2,1,0,0
2023-12-03,13,TEN,IND,Away,381,355,204,300,1,2,177,55,2,0,2,2
2023-12-11,14,MIA,TEN,Away,366,403,208,320,0,1,158,83,2,2,3,3
2023-12-17,15,TEN,HOU,Away,204,340,138,192,0,1,66,148,1,0,1,1
2023-12-24,16,TEN,SEA,Away,287,273,125,215,1,2,162,58,1,0,0,0
2023-12-31,17,HOU,TEN,Home,312,187,201,134,1,0,111,53,0,0,1,1
2024-01-07,18,TEN,JAX,Home,327,362,152,280,2,2,175,82,2,0,1,1
2014-09-07,1,HOU,WAS,Home,321,372,206,241,1,0,115,131,0,1,2,2
2014-09-14,2,WAS,JAX,Home,449,148,258,123,2,1,191,25,3,0,0,0
2014-09-21,3,PHI,WAS,Home,379,511,325,427,3,3,54,84,0,1,1,1
2014-09-25,4,WAS,NYG,Away,329,449,243,295,1,4,86,154,1,2,6,6
2014-10-06,5,WAS,SEA,Away,307,403,275,178,2,2,32,225,0,1,0,0
2014-10-12,6,ARI,WAS,Home,317,407,243,335,2,2,74,72,0,0,4,4
2014-10-19,7,WAS,TEN,Home,351,236,251,160,1,2,100,76,0,0,2,2
2014-10-27,8,DAL,WAS,Away,395,409,224,286,2,0,171,123,0,2,1,1
2014-11-02,9,MIN,WAS,Home,352,347,252,225,1,1,100,122,3,2,1,1
2014-11-16,11,WAS,TAM,Away,322,329,167,281,1,2,155,48,0,0,3,3
2014-11-23,12,SFO,WAS,Home,312,213,246,77,1,0,66,136,1,1,1,1
2014-11-30,13,IND,WAS,Home,487,425,361,341,5,3,126,84,1,0,1,1
2014-12-07,14,WAS,LAR,Away,206,329,179,198,0,2,27,131,0,0,2,2
2014-12-14,15,NYG,WAS,Home,287,372,238,228,3,1,49,144,0,0,1,1
2014-12-20,16,WAS,PHI,Home,305,495,205,361,0,2,100,134,3,1,2,2
2014-12-28,17,WAS,DAL,Away,413,473,309,299,1,2,104,174,1,2,4,4
2015-09-13,1,WAS,MIA,Away,349,256,188,182,1,1,161,74,0,0,2,2
2015-09-20,2,WAS,LAR,Home,373,213,191,146,1,1,182,67,2,0,1,1
2015-09-24,3,NYG,WAS,Home,363,393,279,305,2,1,84,88,1,0,3,3
2015-10-04,4,WAS,PHI,Home,417,320,290,233,1,3,127,87,1,0,1,1
2015-10-11,5,ATL,WAS,Home,418,270,242,219,0,1,176,51,1,1,2,2
2015-10-18,6,NYJ,WAS,Home,474,225,253,191,2,1,221,34,2,0,2,2
2015-10-25,7,WAS,TAM,Home,355,479,305,289,3,2,50,190,1,0,1,1
2015-11-08,9,NWE,WAS,Home,460,250,299,213,2,1,161,37,1,0,2,2
2015-11-15,10,WAS,NOR,Home,510,350,301,192,4,2,209,158,0,0,0,0
2015-11-22,11,CAR,WAS,Home,368,186,226,172,5,1,142,14,0,0,5,5
2015-11-29,12,WAS,NYG,Home,407,332,302,299,1,2,105,33,1,0,0,0
2015-12-07,13,WAS,DAL,Away,266,318,193,221,1,0,73,97,0,1,1,1
2015-12-13,14,CHI,WAS,Away,377,374,290,275,2,1,87,99,1,2,1,1
2015-12-20,15,WAS,BUF,Home,431,452,308,212,4,2,123,240,1,1,1,1
2015-12-26,16,PHI,WAS,Away,398,418,353,351,1,4,45,67,2,0,0,0
2016-01-03,17,DAL,WAS,Away,512,437,412,291,3,4,100,146,0,0,0,0
2016-09-12,1,WAS,PIT,Away,384,437,329,290,0,3,55,147,1,2,2,2
2016-09-18,2,WAS,DAL,Away,432,380,350,278,1,0,82,102,1,3,1,1
2016-09-25,3,NYG,WAS,Away,457,403,337,313,1,2,120,90,2,0,1,1
2016-10-02,4,WAS,CLE,Home,301,380,156,217,3,1,145,163,1,1,1,1
2016-10-09,5,BAL,WAS,Away,306,310,188,250,1,1,118,60,0,0,2,2
2016-10-16,6,WAS,PHI,Home,493,239,263,145,2,0,230,94,1,0,1,1
2016-10-23,7,DET,WAS,Home,344,413,250,283,1,1,94,130,1,1,2,2
2016-10-30,8,CIN,WAS,Home,415,546,263,446,1,2,152,100,3,1,1,1
2016-11-13,10,WAS,MIN,Home,388,331,260,284,2,2,128,47,0,1,1,1
2016-11-20,11,WAS,GNB,Home,515,424,364,340,3,3,151,84,3,0,0,0
2016-11-24,12,DAL,WAS,Home,353,505,190,449,1,3,163,56,3,0,0,0
2016-12-04,13,ARI,WAS,Home,369,333,281,246,3,1,88,87,1,1,2,2
2016-12-11,14,PHI,WAS,Away,383,334,288,227,1,2,95,107,0,2,1,1
2016-12-19,15,WAS,CAR,Away,335,438,306,290,0,2,29,148,1,0,3,3
2016-12-24,16,CHI,WAS,Away,458,478,318,270,2,1,140,208,1,4,0,0
2017-01-01,17,WAS,NYG,Away,284,332,246,171,1,0,38,161,0,1,3,3
2017-09-10,1,WAS,PHI,Away,264,356,200,298,1,2,64,58,0,0,4,4
2017-09-17,2,LAR,WAS,Away,332,385,235,156,1,1,97,229,1,2,0,0
2017-09-24,3,WAS,LVR,Home,472,128,356,96,3,1,116,32,0,0,2,2
2017-10-02,4,KAN,WAS,Home,429,331,261,220,1,2,168,111,1,0,1,1
2017-10-15,6,WAS,SFO,Home,419,335,325,250,2,1,94,85,1,2,2,2
2017-10-23,7,PHI,WAS,Home,371,344,244,269,4,3,127,75,0,0,1,1
2017-10-29,8,WAS,DAL,Away,285,307,236,138,1,0,49,169,1,2,3,3
2017-11-05,9,SEA,WAS,Away,437,244,289,193,2,0,148,51,0,2,1,1
2017-11-12,10,WAS,MIN,Away,394,406,313,304,1,4,81,102,2,1,1,1
2017-11-19,11,NOR,WAS,Home,535,456,375,300,2,3,160,156,1,1,0,0
2017-11-23,12,WAS,NYG,Home,323,170,201,86,2,0,122,84,0,0,1,1
2017-11-30,13,DAL,WAS,Home,275,280,93,224,2,2,182,56,2,0,4,4
2017-12-10,14,LAC,WAS,Home,488,201,314,136,2,1,174,65,1,0,1,1
2017-12-17,15,WAS,ARI,Home,218,286,187,145,2,0,31,141,0,0,1,1
2017-12-24,16,WAS,DEN,Home,386,330,299,171,3,0,87,159,0,1,2,2
2017-12-31,17,NYG,WAS,Home,381,197,121,136,1,0,260,61,1,1,3,3
2018-09-09,1,ARI,WAS,Away,213,429,145,247,0,2,68,182,1,1,1,1
2018-09-16,2,WAS,IND,Away,334,281,269,177,0,2,65,104,0,1,1,1
2018-09-23,3,WAS,GNB,Home,386,340,220,240,2,2,166,100,2,0,1,1
2018-10-08,5,NOR,WAS,Home,447,283,349,244,3,0,98,39,3,2,2,2
2018-10-14,6,WAS,CAR,Home,288,350,156,269,2,2,132,81,0,0,0,0
2018-10-21,7,WAS,DAL,Home,305,323,175,250,1,1,130,73,0,1,0,0
2018-10-28,8,NYG,WAS,Away,303,360,266,178,1,1,37,182,0,1,1,1
2018-11-04,9,WAS,ATL,Away,366,491,287,337,1,4,79,154,1,1,1,1
2018-11-11,10,TAM,WAS,Away,501,286,398,170,0,1,103,116,0,0,0,0
2018-11-18,11,WAS,HOU,Away,278,320,154,181,1,1,124,139,2,0,2,2
2018-11-22,12,DAL,WAS,Home,404,331,258,251,2,2,146,80,2,1,3,3
2018-12-03,13,PHI,WAS,Home,436,235,306,131,2,0,130,104,1,1,1,1
2018-12-09,14,WAS,NYG,Away,288,402,204,175,1,3,84,227,1,1,3,3
2018-12-16,15,JAX,WAS,Away,192,245,20,136,0,1,172,109,0,0,0,0
2018-12-22,16,TEN,WAS,Home,291,292,192,131,1,1,99,161,1,0,2,2
2018-12-30,17,WAS,PHI,Away,89,360,68,231,0,3,21,129,0,0,1,1
2019-09-08,1,PHI,WAS,Home,436,398,313,370,3,3,123,28,1,0,0,0
2019-09-15,2,WAS,DAL,Away,255,474,208,261,2,3,47,213,1,1,0,0
2019-09-23,3,WAS,CHI,Away,356,298,287,208,2,3,69,90,0,0,5,5
2019-09-29,4,NYG,WAS,Home,389,176,225,121,1,0,164,55,1,0,4,4
2019-10-06,5,WAS,NWE,Away,223,442,78,312,0,3,145,130,1,1,2,2
2019-10-13,6,MIA,WAS,Away,271,311,187,166,1,2,84,145,1,0,0,0
2019-10-20,7,WAS,SFO,Away,154,283,50,146,0,0,104,137,0,0,1,1
2019-10-24,8,MIN,WAS,Home,434,216,273,131,0,0,161,85,1,0,2,2
2019-11-03,9,BUF,WAS,Home,268,243,146,116,1,0,122,127,2,0,0,0
2019-11-17,11,WAS,NYJ,Away,225,400,171,285,2,4,54,115,0,1,1,1
2019-11-24,12,WAS,DET,Home,230,364,144,189,0,1,86,175,0,0,2,2
2019-12-01,13,CAR,WAS,Away,278,362,213,114,2,0,65,248,1,3,0,0
2019-12-08,14,GNB,WAS,Home,341,262,167,141,1,1,174,121,1,1,1,1
2019-12-15,15,WAS,PHI,Away,352,415,251,258,2,3,101,157,1,1,1,1
2019-12-22,16,WAS,NYG,Away,361,552,281,346,3,5,80,206,2,1,0,0
2019-12-29,17,DAL,WAS,Home,517,271,294,183,4,1,223,88,1,0,2,2
2020-09-13,1,WAS,PHI,Home,239,265,159,208,1,2,80,57,2,0,0,0
2020-09-20,2,ARI,WAS,Home,438,316,278,199,1,1,160,117,2,1,2,2
2020-09-27,3,CLE,WAS,Home,300,309,142,206,2,2,158,103,2,1,5,5
2020-10-04,4,WAS,BAL,Away,343,350,274,206,0,2,69,144,2,2,1,1
2020-10-11,5,WAS,LAR,Away,108,429,70,300,0,2,38,129,1,2,0,0
2020-10-18,6,NYG,WAS,Home,240,337,108,251,1,2,132,86,0,0,2,2
2020-10-25,7,WAS,DAL,Home,397,142,189,59,2,0,208,83,1,0,0,0
2020-11-08,9,WAS,NYG,Away,402,350,365,184,1,1,37,166,1,1,5,5
2020-11-15,10,DET,WAS,Home,372,464,267,375,3,0,105,89,0,3,1,1
2020-11-22,11,WAS,CIN,Home,325,272,161,202,1,1,164,70,1,0,1,1
2020-11-26,12,DAL,WAS,Away,247,338,187,156,1,1,60,182,0,3,1,1
2020-12-07,13,PIT,WAS,Away,326,318,305,273,2,1,21,45,0,1,0,0
2020-12-13,14,SFO,WAS,Away,344,193,236,95,1,0,108,98,1,0,1,1
2020-12-20,15,WAS,SEA,Away,353,302,269,121,1,1,84,181,1,1,2,2
2020-12-27,16,WAS,CAR,Away,386,280,278,167,1,1,108,113,0,1,4,4
2021-01-03,17,PHI,WAS,Away,216,248,98,145,0,2,118,103,2,0,2,2
2021-09-12,1,WAS,LAC,Away,259,424,133,334,1,1,126,90,0,1,1,1
2021-09-16,2,WAS,NYG,Home,407,391,320,228,2,1,87,163,1,1,1,1
2021-09-26,3,BUF,WAS,Home,481,290,359,212,4,2,122,78,1,1,3,3
2021-10-03,4,ATL,WAS,Away,374,412,275,290,4,3,99,122,0,1,0,0
2021-10-10,5,WAS,NOR,Away,373,369,242,271,0,4,131,98,2,1,2,2
2021-10-17,6,WAS,KAN,Away,276,499,182,390,1,2,94,109,0,2,2,2
2021-10-24,7,GNB,WAS,Home,304,430,247,235,3,1,57,195,0,0,2,2
2021-10-31,8,DEN,WAS,Home,273,342,190,230,1,1,83,112,1,0,2,2
2021-11-14,10,WAS,TAM,Home,320,273,226,220,1,2,94,53,2,0,1,1
2021-11-21,11,CAR,WAS,Away,297,369,186,179,2,3,111,190,1,0,1,1
2021-11-29,12,WAS,SEA,Home,371,267,219,233,1,2,152,34,1,0,1,1
2021-12-05,13,LVR,WAS,Away,310,298,234,186,0,2,76,112,1,0,1,1
2021-12-12,14,WAS,DAL,Away,224,323,124,201,1,1,100,122,1,0,4,4
2021-12-21,15,PHI,WAS,Home,519,237,281,174,1,0,238,63,2,2,0,0
2021-12-26,16,DAL,WAS,Home,497,257,389,172,5,2,108,85,1,0,2,2
2022-01-02,17,WAS,PHI,Away,312,330,218,212,0,0,94,118,1,2,1,1
2022-01-09,18,NYG,WAS,Away,177,325,83,99,1,0,94,226,0,1,0,0
2022-09-11,1,WAS,JAX,Home,390,383,305,260,4,1,85,123,0,1,3,3
2022-09-18,2,DET,WAS,Home,425,396,234,308,4,3,191,88,0,1,1,1
2022-09-25,3,WAS,PHI,Away,240,400,153,328,0,3,87,72,1,0,1,1
2022-10-02,4,DAL,WAS,Home,279,297,217,155,2,1,62,142,0,0,2,2
2022-10-09,5,WAS,TEN,Away,385,241,342,136,2,1,43,105,0,2,1,1
2022-10-13,6,CHI,WAS,Away,391,214,154,86,1,0,237,128,0,1,0,0
2022-10-23,7,WAS,GNB,Home,364,232,198,194,2,2,166,38,0,0,1,1
2022-10-30,8,IND,WAS,Away,324,362,189,266,0,1,135,96,1,1,1,1
2022-11-06,9,WAS,MIN,Away,263,301,126,245,2,2,137,56,0,0,1,1
2022-11-14,10,PHI,WAS,Away,264,330,170,178,2,0,94,152,1,2,2,2
2022-11-20,11,HOU,WAS,Away,148,344,127,191,0,0,21,153,1,1,0,0
2022-11-27,12,WAS,ATL,Home,314,332,138,165,2,1,176,167,0,0,1,1
2022-12-04,13,NYG,WAS,Home,316,411,182,246,1,2,134,165,1,0,1,1
2022-12-18,15,WAS,NYG,Away,387,288,228,160,1,0,159,128,0,1,2,2
2022-12-24,16,SFO,WAS,Home,371,349,218,270,2,3,153,79,2,0,2,2
2023-01-01,17,WAS,CLE,Away,260,301,124,155,0,3,136,146,1,0,3,3
2023-01-08,18,WAS,DAL,Home,309,182,158,118,1,1,151,64,1,0,1,1
2023-09-10,1,WAS,ARI,Home,248,210,156,114,1,0,92,96,1,0,3,3
2023-09-17,2,DEN,WAS,Away,399,388,277,266,3,2,122,122,1,2,0,0
2023-09-24,3,WAS,BUF,Away,230,386,125,218,0,1,105,168,0,2,5,5
2023-10-01,4,PHI,WAS,Home,415,365,311,258,2,1,104,107,1,2,0,0
2023-10-05,5,WAS,CHI,Away,388,451,359,273,2,4,29,178,0,0,2,2
2023-10-15,6,ATL,WAS,Away,402,193,296,121,2,3,106,72,0,0,0,0
2023-10-22,7,NYG,WAS,Home,356,273,250,197,2,0,106,76,0,1,1,1
2023-10-29,8,WAS,PHI,Away,472,374,388,315,4,4,84,59,0,1,1,1
2023-11-05,9,NWE,WAS,Away,327,432,220,308,1,1,107,124,1,1,2,2
2023-11-12,10,SEA,WAS,Home,489,356,369,288,2,3,120,68,0,0,1,1
2023-11-19,11,WAS,NYG,Away,404,292,230,201,1,3,174,91,1,0,6,6
2023-11-23,12,DAL,WAS,Home,431,376,331,268,4,0,100,108,1,1,1,1
2023-12-03,13,WAS,MIA,Away,245,406,107,283,0,2,138,123,2,3,1,1
2023-12-17,15,LAR,WAS,Home,445,297,249,218,2,3,196,79,1,0,1,1
2023-12-24,16,NYJ,WAS,Home,381,245,217,143,1,1,164,102,2,3,3,3
2023-12-31,17,WAS,SFO,Away,225,408,163,224,1,2,62,184,0,1,2,2
2024-01-07,18,WAS,DAL,Away,180,440,130,309,1,4,50,131,0,1,3,3
